PELAAJA,JOUKKUE,O,M,S,P,R,+,-,+/-,L,L%,kausi
Äijälä Eemil,Jymy,19,19,21,40,32,49,51,-2,197,9.6,2024-2025
Iiskola Heikki,Oilers,15,14,24,38,2,38,21,17,107,13.1,2024-2025
Kainulainen Justus,Oilers,16,21,17,38,12,45,28,17,181,11.6,2024-2025
Salokangas Tiitus,Classic,15,19,17,36,2,38,18,20,73,26.0,2024-2025
Ahola Juuso,KrP,15,16,19,35,0,52,29,23,94,17.0,2024-2025
Hakanen Riku,SPV,18,17,18,35,4,46,33,13,131,13.0,2024-2025
Salmi Markus,Oilers,18,19,15,34,2,42,23,19,108,17.6,2024-2025
Salin Eemeli,Classic,17,17,16,33,0,46,25,21,101,16.8,2024-2025
Laakso Mikko,KrP,15,22,8,30,2,43,27,16,88,25.0,2024-2025
Astala Aaro,Oilers,13,22,8,30,2,35,18,17,124,17.7,2024-2025
Lindroos Yannick,FBC,16,9,20,29,2,34,50,-16,80,11.3,2024-2025
Rantala Joona,KrP,15,16,13,29,0,51,28,23,88,18.2,2024-2025
Lastikka Ville,Classic,19,23,6,29,4,43,34,9,116,19.8,2024-2025
Auvinen Jasper,Indians,18,13,15,28,4,44,24,20,137,9.5,2024-2025
Heikkilä Oskari,Classic,19,11,16,27,10,55,31,24,84,13.1,2024-2025
Viitakoski Valtteri,KrP,16,13,14,27,4,42,19,23,67,19.4,2024-2025
Kovanen Joonatan,KrP,16,13,12,25,4,46,27,19,75,17.3,2024-2025
Vaarala Karri,Jymy,15,18,7,25,4,39,39,0,139,12.9,2024-2025
Niemelä Jere,Indians,18,12,12,24,4,40,26,14,81,14.8,2024-2025
Hyvärinen Luukas,KrP,14,9,14,23,4,45,26,19,64,14.1,2024-2025
Einiö Niko,LASB,17,14,9,23,2,30,52,-22,178,7.9,2024-2025
Vesterinen Waltteri,TPS,18,8,14,22,28,36,23,13,124,6.5,2024-2025
Haukkala Konsta,SPV,17,12,10,22,6,33,27,6,138,8.7,2024-2025
Jalo Eero,FBC,17,14,8,22,16,30,49,-19,71,19.7,2024-2025
Junkkarinen Jonne,Happee,18,6,15,21,2,41,27,14,49,12.2,2024-2025
Eloluoto Lauri,TPS,18,13,8,21,4,36,21,15,92,14.1,2024-2025
Laaksonen Nikolas,FBC,17,10,10,20,2,35,54,-19,82,12.2,2024-2025
Keskinen Juuso,SPV,13,14,6,20,4,33,16,17,92,15.2,2024-2025
Tykkyläinen Konsta,Classic,18,15,5,20,2,48,29,19,64,23.4,2024-2025
Koski Sami,SPV,18,5,14,19,2,29,23,6,39,12.8,2024-2025
Huppunen Jesse-Samuli,Indians,13,6,13,19,0,37,20,17,53,11.3,2024-2025
Hyrkkönen Kim,Happee,17,10,9,19,10,40,26,14,121,8.3,2024-2025
Manninen Jami,Classic,15,11,8,19,2,39,26,13,89,12.4,2024-2025
Äijälä Niklas,Jymy,19,7,11,18,4,38,50,-12,60,11.7,2024-2025
Kakko Tuomas,OLS,19,7,11,18,2,31,31,0,88,8.0,2024-2025
Helin Aaro,Classic,19,8,10,18,2,26,21,5,82,9.8,2024-2025
Lassila Jussi,Jymy,19,12,6,18,6,32,47,-15,73,16.4,2024-2025
Kainulainen Valtteri,Indians,16,12,6,18,6,37,18,19,71,16.9,2024-2025
Vänttilä Kimi,OLS,18,14,4,18,2,33,30,3,60,23.3,2024-2025
Malkavs Jorens,LASB,15,8,9,17,10,28,33,-5,82,9.8,2024-2025
Hietaranta Ville,Classic,18,10,7,17,2,27,18,9,35,28.6,2024-2025
Laasonen Roni,Happee,16,10,7,17,6,27,13,14,59,16.9,2024-2025
Stransky Simon,ErVi,12,8,8,16,20,14,30,-16,70,11.4,2024-2025
Ojala Tuomas,TPS,18,9,7,16,10,37,24,13,97,9.3,2024-2025
Möttönen Juuso,ErVi,17,9,7,16,8,22,44,-22,88,10.2,2024-2025
Karjanlahti Eero,SPV,18,10,6,16,2,30,23,7,41,24.4,2024-2025
Ijäs Eetu,OLS,19,4,11,15,30,32,38,-6,47,8.5,2024-2025
Minkkinen Matti,Happee,17,6,9,15,4,18,22,-4,77,7.8,2024-2025
Lukkari Olli,OLS,19,9,6,15,6,23,41,-18,88,10.2,2024-2025
Havula Tatu,Indians,18,9,6,15,2,39,25,14,59,15.3,2024-2025
Heiska Ville,Happee,14,9,6,15,2,36,22,14,52,17.3,2024-2025
Lehkosuo Otto,Indians,17,11,4,15,4,39,25,14,51,21.6,2024-2025
Laine Olli-Akseli,TPS,18,7,7,14,4,31,19,12,77,9.1,2024-2025
Kauppila Oskari,Jymy,18,10,4,14,10,16,39,-23,37,27.0,2024-2025
Sillanpää Oliver,ErVi,17,13,1,14,4,19,33,-14,64,20.3,2024-2025
Harjula Tuomas,Indians,18,6,7,13,0,37,23,14,29,20.7,2024-2025
Liponen Vili,KrP,15,6,7,13,4,40,21,19,19,31.6,2024-2025
Pelto-Arvo Jukka-Pekka,SPV,18,9,4,13,0,23,14,9,43,20.9,2024-2025
Savela Iiro,OLS,17,10,3,13,10,36,36,0,111,9.0,2024-2025
Repo Juho,SPV,17,6,6,12,0,31,24,7,43,14.0,2024-2025
Junnila Samuli,Indians,17,6,6,12,2,32,20,12,86,7.0,2024-2025
Kilpeläinen Aapo,KrP,15,6,6,12,0,21,11,10,36,16.7,2024-2025
Tuononen verneri,FBC,17,9,3,12,16,21,29,-8,72,12.5,2024-2025
Kauppinen Pyry,TPS,15,9,3,12,4,18,12,6,57,15.8,2024-2025
Eklund Alex,TPS,18,11,1,12,8,20,16,4,49,22.4,2024-2025
Sikkinen Eetu,Classic,18,3,8,11,2,42,24,18,37,8.1,2024-2025
Okkonen Roope,OLS,17,3,8,11,0,32,25,7,42,7.1,2024-2025
Simonen Topias,KrP,16,4,7,11,0,35,21,14,29,13.8,2024-2025
Karppanen Teemu,Classic,18,6,5,11,0,17,12,5,36,16.7,2024-2025
Heikkilä Jeri,SPV,18,6,5,11,2,26,17,9,55,10.9,2024-2025
Pöyhtäri Akseli,FBC,14,6,5,11,28,12,30,-18,43,14.0,2024-2025
Forsman Juuso,FBC,17,8,3,11,8,32,52,-20,121,6.6,2024-2025
Sorvali Eetu,Oilers,17,9,2,11,0,36,18,18,51,17.6,2024-2025
Salminen Toni,Classic,17,4,6,10,0,42,20,22,27,14.8,2024-2025
Ollikainen Aaro,FBC,17,4,6,10,28,18,43,-25,44,9.1,2024-2025
Haataja Elias,TPS,18,5,5,10,2,20,6,14,22,22.7,2024-2025
Suomela Antti,Oilers,16,5,5,10,4,47,28,19,61,8.2,2024-2025
Koskinen Valtteri,FBC,15,5,5,10,0,32,45,-13,36,13.9,2024-2025
Trekse Peteris,Classic,19,6,4,10,4,33,27,6,49,12.2,2024-2025
Auranen Leevi,Indians,18,6,4,10,2,29,20,9,37,16.2,2024-2025
Kuisma Niklas,Happee,16,6,4,10,0,39,19,20,39,15.4,2024-2025
Jonaeson Nico,KrP,15,7,3,10,6,39,32,7,30,23.3,2024-2025
Kekki Juuso,Indians,18,3,6,9,2,19,21,-2,34,8.8,2024-2025
Tammiranta Aaro,SPV,16,3,6,9,4,11,3,8,33,9.1,2024-2025
Tenho Oskari,Jymy,19,4,5,9,0,15,33,-18,100,4.0,2024-2025
Suutari Samuel,LASB,17,5,4,9,0,17,34,-17,37,13.5,2024-2025
Karvonen Valte,KrP,16,5,4,9,2,30,14,16,25,20.0,2024-2025
Pasanen Rasmus,Indians,15,5,4,9,8,25,20,5,32,15.6,2024-2025
Kokko Aaro,Happee,18,6,3,9,2,24,21,3,65,9.2,2024-2025
Karjanlahti Eemeli,SPV,18,6,3,9,10,36,25,11,44,13.6,2024-2025
Sulander Jere,LASB,17,6,3,9,32,21,33,-12,62,9.7,2024-2025
Iiskola Tuomas,Oilers,13,6,3,9,4,27,11,16,48,12.5,2024-2025
Laitila Alpo,Classic,18,1,7,8,0,33,34,-1,23,4.3,2024-2025
Karkulowski Emil,LASB,17,3,5,8,6,22,39,-17,33,9.1,2024-2025
Koistinen Eero,ErVi,16,3,5,8,0,8,13,-5,22,13.6,2024-2025
Haverinen Aaro,OLS,16,3,5,8,2,18,33,-15,26,11.5,2024-2025
Tenhonen Daniel,ErVi,17,4,4,8,2,21,32,-11,63,6.3,2024-2025
Karjula Joona,OLS,16,4,4,8,4,18,28,-10,46,8.7,2024-2025
Ukskoski Otto,ErVi,15,4,4,8,4,11,30,-19,28,14.3,2024-2025
Koivisto Veeti,OLS,15,4,4,8,0,10,13,-3,30,13.3,2024-2025
Markkanen Jami,Happee,14,5,3,8,2,8,8,0,25,20.0,2024-2025
Kilpi Otto,Classic,19,1,6,7,12,44,25,19,35,2.9,2024-2025
Ainoa Luka,KrP,16,2,5,7,2,22,10,12,10,20.0,2024-2025
Kuutsa Eero,FBC,17,3,4,7,0,21,43,-22,45,6.7,2024-2025
Saari Arttu,Jymy,16,3,4,7,6,21,36,-15,23,13.0,2024-2025
Ukkonen Eemil,KrP,15,3,4,7,4,31,21,10,15,20.0,2024-2025
Vähäkangas Johannes,FBC,17,4,3,7,2,19,36,-17,30,13.3,2024-2025
Silvonen Jesper,Oilers,17,4,3,7,4,11,6,5,53,7.5,2024-2025
Hutzli Stefan,Happee,17,4,3,7,2,18,19,-1,44,9.1,2024-2025
Mäenpää Matias,Happee,16,4,3,7,0,14,20,-6,41,9.8,2024-2025
Raappana Atte,LASB,13,4,3,7,18,24,35,-11,34,11.8,2024-2025
Laiti Niko,Happee,13,5,2,7,0,10,12,-2,65,7.7,2024-2025
Rautio Petro,Jymy,19,1,5,6,6,46,47,-1,26,3.8,2024-2025
Vaarala Kalle,Happee,18,1,5,6,0,18,14,4,28,3.6,2024-2025
Latvala Miika,SPV,18,1,5,6,8,35,18,17,19,5.3,2024-2025
Wiander Tommi,ErVi,17,1,5,6,10,18,42,-24,23,4.3,2024-2025
Haudanlampi Tuukka,OLS,18,2,4,6,2,14,25,-11,18,11.1,2024-2025
Jokela Olli,Oilers,17,2,4,6,2,34,20,14,19,10.5,2024-2025
Markkola Markus,Oilers,6,2,4,6,2,15,7,8,26,7.7,2024-2025
Suhanto Eppu,Oilers,18,3,3,6,0,31,26,5,48,6.3,2024-2025
Ordning Aapo,FBC,17,3,3,6,4,16,20,-4,11,27.3,2024-2025
Kotka Timi,Happee,17,3,3,6,0,9,13,-4,28,10.7,2024-2025
Järvinen Perttu,Oilers,17,3,3,6,2,12,12,0,23,13.0,2024-2025
Aarela Ilmari,ErVi,17,3,3,6,0,19,39,-20,45,6.7,2024-2025
Rauhala Jani,Indians,16,3,3,6,28,31,17,14,47,6.4,2024-2025
Jaaranen Dani,KrP,14,3,3,6,6,15,14,1,46,6.5,2024-2025
Salminen Olli,ErVi,15,4,2,6,4,13,15,-2,42,9.5,2024-2025
Roth Anton,Indians,18,5,1,6,4,8,8,0,27,18.5,2024-2025
Juha Josef,ErVi,15,5,1,6,2,8,11,-3,32,15.6,2024-2025
Stenfors Lauri,TPS,12,0,5,5,10,28,10,18,10,0.0,2024-2025
Juuti Jasper,TPS,18,2,3,5,4,10,7,3,19,10.5,2024-2025
Tenhonen Benjamin,ErVi,17,2,3,5,0,11,19,-8,25,8.0,2024-2025
Kallio Matias,FBC,15,2,3,5,2,15,16,-1,16,12.5,2024-2025
Alkki Lauri,KrP,14,2,3,5,10,21,14,7,5,40.0,2024-2025
Rantaniemi Aapo,OLS,12,2,3,5,4,12,14,-2,34,5.9,2024-2025
Kinnunen Teuvo,Happee,7,2,3,5,8,7,6,1,32,6.3,2024-2025
Turigin Teemu,Jymy,19,3,2,5,12,19,37,-18,40,7.5,2024-2025
Lillas Didrik,SPV,18,3,2,5,4,20,11,9,27,11.1,2024-2025
Koljonen Perttu,Happee,18,3,2,5,30,15,20,-5,54,5.6,2024-2025
Uusi-Laitila Santeri,SPV,17,3,2,5,2,37,25,12,36,8.3,2024-2025
Lindfors Santeri,Oilers,17,3,2,5,4,17,22,-5,39,7.7,2024-2025
Penicka Matej,ErVi,16,3,2,5,2,13,27,-14,60,5.0,2024-2025
Palvaila Lauri,LASB,16,3,2,5,0,26,38,-12,39,7.7,2024-2025
Vaarimo Miko,ErVi,10,3,2,5,4,8,9,-1,18,16.7,2024-2025
Ylitalo Eemil,OLS,19,4,1,5,0,10,32,-22,56,7.1,2024-2025
Puntanen Eetu,Jymy,19,4,1,5,8,12,33,-21,52,7.7,2024-2025
Niemelä Oliver,TPS,11,4,1,5,4,7,4,3,15,26.7,2024-2025
Koskinen Joonas,TPS,14,0,4,4,4,14,12,2,20,0.0,2024-2025
Lindfors Jesperi,Oilers,8,0,4,4,0,21,7,14,15,0.0,2024-2025
Lindholm Joonatan,Indians,18,1,3,4,2,23,15,8,18,5.6,2024-2025
Pylväläinen Arttu,Happee,17,1,3,4,2,20,18,2,22,4.5,2024-2025
Arkkila Olli,KrP,6,1,3,4,0,14,5,9,9,11.1,2024-2025
Koivisto Aatu,TPS,18,2,2,4,0,13,16,-3,28,7.1,2024-2025
Autio Janne,SPV,18,2,2,4,4,13,7,6,28,7.1,2024-2025
Niemelä Petri,OLS,16,2,2,4,8,7,19,-12,25,8.0,2024-2025
Lokasaari Aapo,SPV,16,2,2,4,0,8,5,3,21,9.5,2024-2025
Larte Joona,Oilers,15,2,2,4,4,25,13,12,9,22.2,2024-2025
Suominen Marius,FBC,13,2,2,4,2,4,9,-5,11,18.2,2024-2025
Koppanen Joe,FBC,16,3,1,4,0,5,13,-8,22,13.6,2024-2025
Maronen Markus,Indians,11,3,1,4,0,6,4,2,15,20.0,2024-2025
Piskacek Bohumil,ErVi,17,0,3,3,8,14,25,-11,37,0.0,2024-2025
Viitikka Oskari,TPS,16,0,3,3,6,10,6,4,6,0.0,2024-2025
Porttikivi Pietari,LASB,13,0,3,3,4,4,17,-13,16,0.0,2024-2025
Virtanen Viljami,Classic,10,0,3,3,2,5,7,-2,4,0.0,2024-2025
Nissilä Juuso,OLS,17,1,2,3,0,6,10,-4,21,4.8,2024-2025
Mustonen Justus,Oilers,17,1,2,3,2,13,10,3,6,16.7,2024-2025
Lehtonen Eetu,TPS,17,1,2,3,2,16,14,2,15,6.7,2024-2025
Ryytty Valtteri,LASB,16,1,2,3,0,14,26,-12,14,7.1,2024-2025
Luhtala Aatu,Jymy,16,1,2,3,0,17,26,-9,21,4.8,2024-2025
Aho Tuomas,ErVi,14,1,2,3,6,18,25,-7,16,6.3,2024-2025
Salo Tuukka,Classic,18,2,1,3,4,19,16,3,13,15.4,2024-2025
Rautakoura Ville,Indians,17,2,1,3,4,12,16,-4,20,10.0,2024-2025
Jaanus Janne,LASB,16,2,1,3,2,14,36,-22,18,11.1,2024-2025
Salokangas Julius,LASB,10,2,1,3,0,7,21,-14,28,7.1,2024-2025
Kinnunen Olli,KrP,10,2,1,3,4,17,14,3,12,16.7,2024-2025
Pekari Elias,Oilers,18,3,0,3,4,10,12,-2,24,12.5,2024-2025
Wingren Elliot,FBC,16,3,0,3,4,10,16,-6,17,17.6,2024-2025
Kurkikangas Atte,FBC,14,3,0,3,2,16,34,-18,16,18.8,2024-2025
Wikström Roope,Jymy,19,0,2,2,2,8,24,-16,12,0.0,2024-2025
Karjalainen Aki,Jymy,19,0,2,2,0,0,0,0,0,-,2024-2025
Saarela Miko,Jymy,18,0,2,2,6,12,33,-21,13,0.0,2024-2025
Ahola Vili,LASB,17,0,2,2,16,7,26,-19,14,0.0,2024-2025
Huhtakallio Eemeli,Classic,13,0,2,2,0,13,6,7,1,0.0,2024-2025
Paulaharju Simo,KrP,12,0,2,2,6,7,6,1,10,0.0,2024-2025
Seppälä Juho,Oilers,11,0,2,2,2,8,8,0,12,0.0,2024-2025
Tiittala Leo,ErVi,10,0,2,2,0,4,11,-7,16,0.0,2024-2025
Lindstedt Tino,LASB,8,0,2,2,0,6,7,-1,6,0.0,2024-2025
Koskinen Juho,TPS,18,1,1,2,2,13,14,-1,27,3.7,2024-2025
Virrankari Olli-Matti,Happee,17,1,1,2,2,18,19,-1,10,10.0,2024-2025
Nyman Elias,Jymy,17,1,1,2,2,5,19,-14,15,6.7,2024-2025
Mäkimarttunen Saku,LASB,17,1,1,2,4,4,14,-10,34,2.9,2024-2025
Marthaler Mael,LASB,17,1,1,2,0,6,25,-19,16,6.3,2024-2025
Liikka Saku,Jymy,17,1,1,2,0,1,10,-9,10,10.0,2024-2025
Hokkanen Joona,Oilers,16,1,1,2,2,8,6,2,30,3.3,2024-2025
Niemelä Marius,Happee,15,1,1,2,2,8,11,-3,16,6.3,2024-2025
Mertaniemi Väinö,OLS,15,1,1,2,4,10,19,-9,31,3.2,2024-2025
Lamminen Janne,Classic,12,1,1,2,0,12,19,-7,8,12.5,2024-2025
Salminen Sami,LASB,11,1,1,2,0,3,13,-10,14,7.1,2024-2025
Leppäniemi Samuli,Classic,9,1,1,2,0,7,3,4,13,7.7,2024-2025
Pernu Valtteri,Happee,13,2,0,2,0,6,7,-1,8,25.0,2024-2025
Mäenpää Eero,Jymy,9,2,0,2,0,3,5,-2,4,50.0,2024-2025
Aro Konsta,KrP,8,2,0,2,2,5,1,4,8,25.0,2024-2025
Liukkonen Teppo,SPV,18,0,1,1,0,0,0,0,0,-,2024-2025
Kuisma Olli,TPS,18,0,1,1,0,0,0,0,0,-,2024-2025
Kaltiainen Joonas,Indians,18,0,1,1,0,0,0,0,0,-,2024-2025
Holappa Niko-Petteri,OLS,18,0,1,1,0,12,18,-6,3,0.0,2024-2025
Hellsten Rasmus,Oilers,18,0,1,1,0,0,0,0,0,-,2024-2025
Manninen Eetu,Jymy,17,0,1,1,2,6,18,-12,2,0.0,2024-2025
Kriz Lukas,ErVi,17,0,1,1,0,0,0,0,0,-,2024-2025
Ranta Justus,Jymy,14,0,1,1,10,3,13,-10,5,0.0,2024-2025
Harinen Simo,LASB,14,0,1,1,2,1,3,-2,1,0.0,2024-2025
Turula Veli-Pekka,ErVi,13,0,1,1,0,5,10,-5,3,0.0,2024-2025
Helin Vilho,Classic,12,0,1,1,2,12,1,11,10,0.0,2024-2025
Haapala Arttu,Oilers,11,0,1,1,2,5,7,-2,13,0.0,2024-2025
Moislahti Rasmus,FBC,10,0,1,1,0,9,12,-3,0,-,2024-2025
Maksimainen Olli,LASB,9,0,1,1,2,2,15,-13,9,0.0,2024-2025
Palojoki Jooa,ErVi,7,0,1,1,0,4,4,0,9,0.0,2024-2025
Fredriksson Mikael,FBC,5,0,1,1,0,5,9,-4,5,0.0,2024-2025
Dias Lino,FBC,3,0,1,1,0,3,1,2,1,0.0,2024-2025
Vainionpää Markus,Classic,1,0,1,1,0,2,0,2,6,0.0,2024-2025
Kantonen Kasperi,TPS,18,1,0,1,0,2,0,2,3,33.3,2024-2025
Järvikangas Viljami,SPV,18,1,0,1,0,23,11,12,17,5.9,2024-2025
Rantala Peetu,LASB,17,1,0,1,4,8,41,-33,12,8.3,2024-2025
Mustonen Juho,OLS,16,1,0,1,8,3,10,-7,18,5.6,2024-2025
Kosonen Miika,LASB,16,1,0,1,0,2,11,-9,22,4.5,2024-2025
Hakola Jesper,TPS,16,1,0,1,0,4,0,4,4,25.0,2024-2025
Välitalo Anssi,OLS,14,1,0,1,0,2,11,-9,11,9.1,2024-2025
Grönfors Samuli,Happee,13,1,0,1,0,2,2,0,4,25.0,2024-2025
Koivisto Lassi,ErVi,12,1,0,1,0,2,4,-2,14,7.1,2024-2025
Haikola Kai,OLS,11,1,0,1,2,6,9,-3,8,12.5,2024-2025
Laukkanen Jarno,KrP,9,1,0,1,0,9,3,6,7,14.3,2024-2025
Siekkinen Paavo,Happee,7,1,0,1,0,1,2,-1,7,14.3,2024-2025
Harmaala Aatu,LASB,5,1,0,1,0,1,9,-8,29,3.4,2024-2025
Tuominen Sami,FBC,2,1,0,1,0,1,4,-3,1,100.0,2024-2025
Rantaniemi Iiro,OLS,19,0,0,0,0,0,0,0,0,-,2024-2025
Hanousek Martin,Jymy,19,0,0,0,0,0,0,0,0,-,2024-2025
Rintala Toni,Indians,18,0,0,0,0,2,1,1,7,0.0,2024-2025
Panuma Riku,OLS,18,0,0,0,0,0,0,0,0,-,2024-2025
Jokisalo Juuso,Indians,18,0,0,0,0,0,0,0,0,-,2024-2025
Hasu Rasmus,SPV,18,0,0,0,0,0,0,0,0,-,2024-2025
Auvinen Otso,Classic,18,0,0,0,0,0,0,0,0,-,2024-2025
Rehu Santtu,OLS,17,0,0,0,4,8,26,-18,22,0.0,2024-2025
Ojala Touko,ErVi,17,0,0,0,0,0,0,0,0,-,2024-2025
Jääskeläinen Pietari,Happee,17,0,0,0,0,0,0,0,1,0.0,2024-2025
Fälden Oskari,TPS,17,0,0,0,0,0,0,0,0,-,2024-2025
Aaltokallio Miika,Happee,17,0,0,0,0,0,0,0,0,-,2024-2025
Tuomala Miro,KrP,16,0,0,0,0,0,0,0,0,-,2024-2025
Laakso Elmeri,FBC,16,0,0,0,0,0,0,0,1,0.0,2024-2025
Kerola Jacob,ErVi,16,0,0,0,2,3,4,-1,0,-,2024-2025
Tuononen Roni,KrP,15,0,0,0,0,0,0,0,0,-,2024-2025
Pohjonen Santtu,LASB,15,0,0,0,2,0,0,0,0,-,2024-2025
Luukko Joona,Jymy,15,0,0,0,6,4,11,-7,2,0.0,2024-2025
Hämäläinen Miika,FBC,15,0,0,0,2,12,18,-6,5,0.0,2024-2025
Beijar Jens,FBC,15,0,0,0,0,0,0,0,0,-,2024-2025
Laakso Markus,Oilers,14,0,0,0,0,0,0,0,0,-,2024-2025
Honkonen Arttu,SPV,13,0,0,0,0,0,2,-2,2,0.0,2024-2025
Pirhonen Elias,ErVi,12,0,0,0,0,5,8,-3,12,0.0,2024-2025
Kajaala Joona,SPV,11,0,0,0,2,3,3,0,16,0.0,2024-2025
Harjula Eero,Indians,11,0,0,0,0,4,4,0,10,0.0,2024-2025
Forss Onni,Indians,11,0,0,0,0,2,2,0,1,0.0,2024-2025
Toriseva Lassi,Classic,10,0,0,0,0,0,0,0,0,-,2024-2025
Rannanjärvi Jaakko,TPS,10,0,0,0,0,1,1,0,3,0.0,2024-2025
Korhonen Teemu,LASB,10,0,0,0,0,0,0,0,0,-,2024-2025
Järvinen Pasi,LASB,9,0,0,0,0,0,0,0,0,-,2024-2025
Talvitie Ilari,Oilers,8,0,0,0,2,5,6,-1,11,0.0,2024-2025
Peltoniemi Veeti,Classic,8,0,0,0,0,0,0,0,0,-,2024-2025
Ojanperä Aleksi,Jymy,8,0,0,0,0,0,1,-1,2,0.0,2024-2025
Ojala Jani,Jymy,8,0,0,0,2,2,8,-6,6,0.0,2024-2025
Haavisto Aapo,SPV,8,0,0,0,0,0,0,0,0,-,2024-2025
Santanen Mikko,SPV,7,0,0,0,0,7,8,-1,4,0.0,2024-2025
Loponen Eetu,TPS,7,0,0,0,0,2,1,1,1,0.0,2024-2025
Hänninen Arttu,OLS,7,0,0,0,2,3,16,-13,8,0.0,2024-2025
Paajanen Veikko,TPS,6,0,0,0,0,0,1,-1,0,-,2024-2025
Lähdesmäki Lassi,FBC,6,0,0,0,2,0,1,-1,0,-,2024-2025
Juuranto Matias,Oilers,6,0,0,0,0,1,5,-4,8,0.0,2024-2025
Dias Daniel,FBC,6,0,0,0,0,3,14,-11,2,0.0,2024-2025
Tuominen Julius,Happee,5,0,0,0,0,2,0,2,0,-,2024-2025
Salin Luukas,SPV,5,0,0,0,0,0,0,0,0,-,2024-2025
Laatikainen Aleksi,Oilers,5,0,0,0,0,1,3,-2,4,0.0,2024-2025
Kulmala Kasper,TPS,5,0,0,0,0,0,0,0,0,-,2024-2025
Koski Matias,TPS,5,0,0,0,0,2,3,-1,6,0.0,2024-2025
Virolainen Luukas,OLS,4,0,0,0,0,1,1,0,1,0.0,2024-2025
Ruonakangas Riku,OLS,4,0,0,0,0,0,5,-5,5,0.0,2024-2025
Mertsalmi Henri,LASB,4,0,0,0,0,0,1,-1,1,0.0,2024-2025
Jäärni Tuukka,OLS,4,0,0,0,0,0,3,-3,1,0.0,2024-2025
Jyrkiäinen Matti,SPV,4,0,0,0,0,0,0,0,0,-,2024-2025
Hakokorpi Pietu,Oilers,4,0,0,0,0,0,0,0,0,-,2024-2025
Dumpis Markuss,Indians,4,0,0,0,0,1,1,0,2,0.0,2024-2025
Stukans Karlis,KrP,3,0,0,0,0,0,0,0,0,-,2024-2025
Roimela Setti,Indians,3,0,0,0,0,0,0,0,3,0.0,2024-2025
Nykänen Eetu,Oilers,3,0,0,0,0,6,3,3,4,0.0,2024-2025
Niemelä Eetu,Oilers,3,0,0,0,0,0,1,-1,0,-,2024-2025
Junkkari Jonatan,Indians,3,0,0,0,0,0,0,0,1,0.0,2024-2025
Hallbäck Marek,FBC,3,0,0,0,0,0,0,0,0,-,2024-2025
Tuomala Miiko,Happee,2,0,0,0,0,0,0,0,0,-,2024-2025
Römpötti Oula,Happee,2,0,0,0,0,0,2,-2,1,0.0,2024-2025
Kangas Pietu,Happee,2,0,0,0,0,0,0,0,0,-,2024-2025
Hiltunen Aleksi,FBC,2,0,0,0,0,3,0,3,0,-,2024-2025
Corell Matias,Classic,2,0,0,0,0,0,0,0,0,-,2024-2025
Zlesák Ondřej,Oilers,1,0,0,0,0,0,0,0,0,-,2024-2025
Virta Saku,KrP,1,0,0,0,0,0,0,0,0,-,2024-2025
Telkki Axel,ErVi,1,0,0,0,0,0,0,0,0,-,2024-2025
Siira Jami,OLS,1,0,0,0,0,0,0,0,0,-,2024-2025
Saarikko Sami,KrP,1,0,0,0,0,0,0,0,0,-,2024-2025
Nyström Rasmus,Classic,1,0,0,0,0,2,0,2,1,0.0,2024-2025
Mankinen Arttu,TPS,1,0,0,0,0,0,0,0,0,-,2024-2025
Lahti Jere,Indians,1,0,0,0,0,0,0,0,0,-,2024-2025
Karjalainen Joona,LASB,1,0,0,0,0,0,0,0,0,-,2024-2025
Kantola Karo,LASB,1,0,0,0,0,0,0,0,1,0.0,2024-2025
Jaurakkajärvi Esa,OLS,1,0,0,0,0,0,2,-2,0,-,2024-2025
Halmela Teemu,KrP,1,0,0,0,0,1,2,-1,3,0.0,2024-2025
Lastikka Ville,Classic,33,55,36,91,6,111,47,64,241,22.8,2023-2024
Kainulainen Justus,Oilers,33,52,25,77,10,88,53,35,343,15.2,2023-2024
Rantala Joona,KrP,33,43,23,66,20,101,67,34,217,19.8,2023-2024
Hyvärinen Luukas,OLS,33,33,30,63,12,74,67,7,198,16.7,2023-2024
Salin Eemeli,Classic,28,34,29,63,10,93,42,51,184,18.5,2023-2024
Heikkilä Oskari,Classic,32,37,25,62,8,100,41,59,226,16.4,2023-2024
Kovanen Joonatan,KrP,32,29,30,59,0,93,65,28,184,15.8,2023-2024
Laakso Mikko,KrP,33,40,18,58,6,86,65,21,181,22.1,2023-2024
Hakanen Riku,SPV,33,25,31,56,18,83,68,15,227,11.0,2023-2024
Stransky Simon,ErVi,33,27,28,55,32,64,101,-37,163,16.6,2023-2024
Iiskola Heikki,Oilers,28,23,30,53,22,75,33,42,161,14.3,2023-2024
Salo Nico,Classic,27,11,39,50,4,89,36,53,70,15.7,2023-2024
Manninen Jami,Happee,33,23,27,50,12,76,68,8,230,10.0,2023-2024
Äijälä Eemil,Jymy,33,25,25,50,14,53,74,-21,265,9.4,2023-2024
Iiskola Tuomas,Oilers,29,30,20,50,12,80,31,49,136,22.1,2023-2024
Helin Aaro,Classic,33,39,11,50,6,91,45,46,184,21.2,2023-2024
Keskinen Juuso,SPV,27,29,19,48,8,62,46,16,166,17.5,2023-2024
Kainulainen Rasmus,Oilers,28,22,24,46,22,69,30,39,150,14.7,2023-2024
Majer Petr,Indians,33,25,21,46,4,64,26,38,162,15.4,2023-2024
Trekse Peteris,TPS,33,21,24,45,14,81,48,33,135,15.6,2023-2024
Penicka Matej,ErVi,33,26,19,45,12,57,103,-46,249,10.4,2023-2024
Viitakoski Valtteri,KrP,32,26,18,44,2,80,47,33,123,21.1,2023-2024
Salmi Markus,Happee,31,26,18,44,12,64,61,3,234,11.1,2023-2024
Kinnunen Olli,OLS,31,18,24,42,6,72,63,9,141,12.8,2023-2024
Auvinen Jasper,Indians,33,25,17,42,12,73,44,29,206,12.1,2023-2024
Haukkala Konsta,SPV,32,27,15,42,22,77,63,14,263,10.3,2023-2024
Ahola Juuso,KrP,26,17,24,41,8,62,36,26,111,15.3,2023-2024
Astala Aaro,Oilers,23,21,20,41,6,56,40,16,156,13.5,2023-2024
Jonaeson Nico,KrP,33,11,29,40,6,83,57,26,93,11.8,2023-2024
Junnila Samuli,Indians,31,27,13,40,14,61,44,17,212,12.7,2023-2024
Koski Sami,SPV,33,7,32,39,2,38,29,9,63,11.1,2023-2024
Vesterinen Waltteri,TPS,33,21,18,39,12,63,54,9,179,11.7,2023-2024
Eloluoto Lauri,TPS,32,25,14,39,8,64,48,16,141,17.7,2023-2024
Kainulainen Valtteri,Indians,30,24,14,38,4,69,59,10,136,17.6,2023-2024
Laiti Niko,Happee,33,25,11,36,36,58,53,5,147,17.0,2023-2024
Niemelä Jere,TPS,31,15,19,34,32,83,57,26,190,7.9,2023-2024
Havula Tatu,LASB,33,12,21,33,2,63,78,-15,108,11.1,2023-2024
Ahokas Aleksi,TPS,29,21,12,33,8,61,30,31,73,28.8,2023-2024
Pelto-Arvo Jukka-Pekka,SPV,32,24,8,32,4,39,37,2,95,25.3,2023-2024
Mäkinen Miska,KrP,32,11,20,31,2,88,62,26,50,22.0,2023-2024
Ojala Tuomas,TPS,33,12,19,31,16,65,57,8,105,11.4,2023-2024
Salokangas Tiitus,LASB,32,16,15,31,4,49,68,-19,169,9.5,2023-2024
Savela Iiro,OLS,31,17,14,31,12,62,58,4,133,12.8,2023-2024
Hankkio Jari,Jymy,23,11,19,30,48,36,34,2,104,10.6,2023-2024
Auranen Leevi,Indians,33,13,17,30,10,70,60,10,94,13.8,2023-2024
Kekki Juuso,Indians,32,15,14,29,4,59,42,17,87,17.2,2023-2024
Äijälä Niklas,Jymy,33,14,14,28,8,62,59,3,78,17.9,2023-2024
Surakka Joonatan,LASB,30,14,14,28,6,61,69,-8,102,13.7,2023-2024
Minkkinen Matti,Happee,32,18,10,28,4,57,45,12,143,12.6,2023-2024
Möttönen Juuso,ErVi,33,20,8,28,6,63,102,-39,125,16.0,2023-2024
Huppunen Jesse-Samuli,Indians,23,9,18,27,2,57,58,-1,74,12.2,2023-2024
Lindfors Santeri,Oilers,32,11,16,27,6,59,29,30,70,15.7,2023-2024
Laaksonen Nikolas,FBC,33,12,15,27,24,42,98,-56,109,11.0,2023-2024
Karjula Joona,OLS,33,17,10,27,8,75,57,18,107,15.9,2023-2024
Karjanlahti Eero,SPV,32,17,10,27,18,51,56,-5,125,13.6,2023-2024
Junkkarinen Jonne,Happee,32,10,16,26,38,70,62,8,79,12.7,2023-2024
Vaarala Karri,Jymy,33,16,10,26,4,57,63,-6,188,8.5,2023-2024
Johansson Henri,KrP,32,16,10,26,4,58,42,16,85,18.8,2023-2024
Sipronen Markus,Happee,31,11,14,25,26,68,64,4,71,15.5,2023-2024
Tammiranta Aaro,SPV,32,15,10,25,6,48,49,-1,82,18.3,2023-2024
Tuononen verneri,FBC,28,17,8,25,16,36,72,-36,108,15.7,2023-2024
Mäenpää Matias,Jymy,33,20,5,25,16,55,60,-5,210,9.5,2023-2024
Suomela Antti,Oilers,32,8,16,24,6,81,53,28,82,9.8,2023-2024
Markkola Markus,Oilers,20,8,16,24,8,41,20,21,58,13.8,2023-2024
Salminen Toni,Classic,30,10,14,24,2,77,35,42,57,17.5,2023-2024
Koskinen Albert,Classic,31,12,12,24,14,41,26,15,125,9.6,2023-2024
Laitila Alpo,Classic,33,8,15,23,4,98,47,51,46,17.4,2023-2024
Laine Olli-Akseli,TPS,26,12,11,23,24,45,51,-6,121,9.9,2023-2024
Heiska Ville,Happee,33,16,7,23,2,46,40,6,92,17.4,2023-2024
Kurkikangas Atte,FBC,29,17,6,23,4,31,76,-45,85,20.0,2023-2024
Einiö Niko,LASB,27,20,3,23,28,41,61,-20,150,13.3,2023-2024
Suhanto Eppu,Happee,33,9,13,22,4,68,61,7,105,8.6,2023-2024
Tiltins Krisjanis,FBC,26,15,7,22,12,28,69,-41,120,12.5,2023-2024
Ukkonen Eemil,KrP,29,6,15,21,4,67,38,29,26,23.1,2023-2024
Hemerka Adam,Classic,30,7,14,21,22,78,43,35,89,7.9,2023-2024
Laasonen Roni,Happee,24,10,11,21,10,47,42,5,114,8.8,2023-2024
Juuti Jasper,LASB,31,14,7,21,2,31,59,-28,126,11.1,2023-2024
Eklund Alex,TPS,28,15,6,21,2,41,27,14,76,19.7,2023-2024
Akola Eemeli,Classic,33,3,17,20,10,100,44,56,47,6.4,2023-2024
Ollikainen Aaro,FBC,31,6,14,20,8,44,84,-40,83,7.2,2023-2024
Autio Janne,SPV,32,10,10,20,4,49,51,-2,41,24.4,2023-2024
Wikstedt Olli,OLS,31,10,10,20,12,72,66,6,75,13.3,2023-2024
Lindholm Joonatan,Indians,33,11,9,20,8,70,50,20,85,12.9,2023-2024
Sillanpää Oliver,ErVi,20,14,6,20,4,18,54,-36,90,15.6,2023-2024
Stenfors Lauri,TPS,30,7,12,19,6,68,34,34,37,18.9,2023-2024
Tykkyläinen Konsta,Classic,32,10,9,19,6,95,41,54,120,8.3,2023-2024
Sorvali Eetu,Oilers,32,14,5,19,4,37,25,12,71,19.7,2023-2024
Lindfors Jesperi,Oilers,25,6,12,18,0,61,22,39,37,16.2,2023-2024
Nivala Tino,LASB,33,9,9,18,4,61,75,-14,77,11.7,2023-2024
Lillas Didrik,SPV,33,9,9,18,6,36,19,17,56,16.1,2023-2024
Kauppinen Pyry,TPS,24,9,9,18,8,36,23,13,61,14.8,2023-2024
Rintala Toni,Indians,28,11,7,18,6,32,32,0,76,14.5,2023-2024
Tenhonen Daniel,ErVi,33,13,5,18,12,37,89,-52,99,13.1,2023-2024
Juuranto Matias,Oilers,18,13,5,18,6,30,7,23,55,23.6,2023-2024
Kinnunen Teuvo,Happee,28,11,6,17,4,23,23,0,77,14.3,2023-2024
Pasanen Rasmus,Indians,24,11,6,17,8,39,31,8,83,13.3,2023-2024
Harjula Tuomas,Indians,33,1,15,16,0,64,49,15,50,2.0,2023-2024
Sikkinen Eetu,Classic,22,7,9,16,12,63,26,37,50,14.0,2023-2024
Rauhala Jani,Indians,24,8,8,16,18,53,47,6,77,10.4,2023-2024
Liponen Vili,KrP,19,9,7,16,4,40,19,21,42,21.4,2023-2024
Hoikkanen Janne,TPS,32,10,6,16,6,59,35,24,65,15.4,2023-2024
Roth Anton,Indians,31,10,6,16,8,36,7,29,34,29.4,2023-2024
Sariola Eetu,Jymy,29,13,3,16,24,25,47,-22,91,14.3,2023-2024
Rautakoura Ville,Indians,31,8,7,15,2,60,17,43,65,12.3,2023-2024
Järvikangas Viljami,SPV,31,11,4,15,24,67,47,20,39,28.2,2023-2024
Lehtonen Konsta,LASB,18,12,3,15,10,21,21,0,63,19.0,2023-2024
Rautio Petro,Jymy,33,1,13,14,4,52,46,6,36,2.8,2023-2024
Wiander Tommi,ErVi,33,4,10,14,20,60,96,-36,66,6.1,2023-2024
Vaarala Kalle,Jymy,33,8,6,14,20,45,63,-18,98,8.2,2023-2024
Nykänen Eetu,Oilers,32,4,9,13,14,61,38,23,64,6.3,2023-2024
Sulander Jere,LASB,33,7,6,13,6,24,54,-30,82,8.5,2023-2024
Griezitis Gustavs,FBC,32,8,5,13,36,35,72,-37,83,9.6,2023-2024
Vänttilä Kimi,OLS,33,9,4,13,4,31,52,-21,65,13.8,2023-2024
Hakola Jesper,OLS,23,9,4,13,4,24,26,-2,52,17.3,2023-2024
Hietaranta Ville,Classic,33,10,3,13,8,25,22,3,58,17.2,2023-2024
Latvala Miika,SPV,32,4,8,12,2,53,58,-5,34,11.8,2023-2024
Parviainen Valtteri,OLS,28,5,7,12,4,22,29,-7,62,8.1,2023-2024
Tuominen Sami,FBC,25,5,7,12,6,28,55,-27,56,8.9,2023-2024
Niemelä Petri,OLS,33,6,6,12,6,22,26,-4,30,20.0,2023-2024
Lahti Joel,Happee,33,6,6,12,6,63,68,-5,55,10.9,2023-2024
Alatalo Pieti,Indians,33,6,6,12,30,53,22,31,63,9.5,2023-2024
Forsman Juuso,FBC,31,6,6,12,6,30,94,-64,136,4.4,2023-2024
Raappana Atte,LASB,33,7,5,12,6,60,71,-11,73,9.6,2023-2024
Kilpi Otto,Classic,30,7,5,12,38,30,23,7,47,14.9,2023-2024
Veikkola Matias,Oilers,21,7,5,12,6,45,28,17,37,18.9,2023-2024
Reunamäki Riku,Oilers,31,10,2,12,20,31,13,18,33,30.3,2023-2024
Välitalo Anssi,OLS,31,3,8,11,4,24,30,-6,24,12.5,2023-2024
Ijäs Eetu,OLS,30,3,8,11,8,30,50,-20,55,5.5,2023-2024
Uusi-Laitila Santeri,SPV,33,4,7,11,8,58,43,15,47,8.5,2023-2024
Koskinen Joonas,TPS,31,4,7,11,10,40,38,2,49,8.2,2023-2024
Puntanen Eetu,Jymy,33,7,4,11,10,22,33,-11,52,13.5,2023-2024
Lindroos Yannick,FBC,22,7,4,11,4,24,41,-17,50,14.0,2023-2024
Mattila Jere,KrP,29,8,3,11,8,58,41,17,56,14.3,2023-2024
Lassila Jussi,Jymy,20,9,2,11,2,27,23,4,45,20.0,2023-2024
Tenhonen Benjamin,ErVi,33,2,8,10,14,23,70,-47,57,3.5,2023-2024
Santanen Mikko,SPV,25,3,7,10,0,25,40,-15,30,10.0,2023-2024
Ruonakangas Riku,OLS,32,4,6,10,10,20,28,-8,72,5.6,2023-2024
Kotka Timi,Happee,32,4,6,10,6,15,13,2,42,9.5,2023-2024
Malkavs Jorens,KrP,28,4,6,10,4,13,10,3,26,15.4,2023-2024
Pylväläinen Arttu,Happee,25,4,6,10,0,40,21,19,33,12.1,2023-2024
Simonen Topias,KrP,32,5,5,10,8,31,20,11,37,13.5,2023-2024
Paulaharju Simo,KrP,31,5,5,10,4,18,11,7,56,8.9,2023-2024
Näveri Vili,LASB,31,5,5,10,4,22,56,-34,42,11.9,2023-2024
Pöyhtäri Akseli,OLS,20,7,3,10,4,17,18,-1,73,9.6,2023-2024
Silvonen Jesper,Oilers,19,7,3,10,2,16,13,3,33,21.2,2023-2024
Kallio Matias,FBC,31,8,2,10,2,21,53,-32,74,10.8,2023-2024
Jokela Olli,Oilers,31,2,7,9,4,29,16,13,30,6.7,2023-2024
Lehtonen Eetu,TPS,31,5,4,9,4,32,22,10,31,16.1,2023-2024
Kauppila Oskari,Jymy,33,6,3,9,8,24,40,-16,48,12.5,2023-2024
Aarela Ilmari,ErVi,32,2,6,8,6,21,66,-45,42,4.8,2023-2024
Heikkilä Jeri,SPV,33,4,4,8,10,53,38,15,72,5.6,2023-2024
Alkki Lauri,KrP,33,4,4,8,4,39,32,7,23,17.4,2023-2024
Siekkinen Kaapo,Happee,12,4,4,8,0,22,24,-2,56,7.1,2023-2024
Arkkila Olli,KrP,32,5,3,8,10,30,25,5,51,9.8,2023-2024
Koivisto Lassi,ErVi,32,6,2,8,8,10,47,-37,51,11.8,2023-2024
Lamminen Janne,Classic,28,6,2,8,10,29,28,1,32,18.8,2023-2024
Piskacek Bohumil,ErVi,33,1,6,7,8,26,69,-43,72,1.4,2023-2024
Remes Christian,Indians,20,1,6,7,2,19,23,-4,76,1.3,2023-2024
Niemelä Marius,Happee,18,1,6,7,2,23,30,-7,22,4.5,2023-2024
Viitanen Joonas,FBC,15,1,6,7,4,12,42,-30,33,3.0,2023-2024
Jaanus Janne,LASB,32,2,5,7,2,30,53,-23,43,4.7,2023-2024
Rantaniemi Aapo,OLS,19,2,5,7,6,18,24,-6,26,7.7,2023-2024
Kerola Jacob,ErVi,33,3,4,7,6,20,60,-40,33,9.1,2023-2024
Virrankari Olli-Matti,OLS,29,3,4,7,0,26,39,-13,18,16.7,2023-2024
Pekari Elias,Oilers,26,4,3,7,2,20,12,8,40,10.0,2023-2024
Hyrkkönen Kim,KrP,23,4,3,7,4,24,11,13,67,6.0,2023-2024
Helin Vilho,Classic,17,4,3,7,0,20,33,-13,41,9.8,2023-2024
Ylitalo Eemil,OLS,17,5,2,7,6,17,22,-5,34,14.7,2023-2024
Koskinen Juho,TPS,28,1,5,6,6,16,10,6,10,10.0,2023-2024
Tähkä Kasper,Happee,25,1,5,6,2,23,23,0,18,5.6,2023-2024
Dumpis Markuss,Indians,7,1,5,6,0,8,2,6,8,12.5,2023-2024
Haataja Elias,TPS,31,2,4,6,4,20,17,3,14,14.3,2023-2024
Siegfried Noé,Jymy,24,2,4,6,2,9,11,-2,19,10.5,2023-2024
Nyman Elias,Jymy,18,2,4,6,0,12,16,-4,16,12.5,2023-2024
Saari Arttu,Jymy,32,4,2,6,16,41,53,-12,44,9.1,2023-2024
Wingren Elliot,FBC,27,4,2,6,2,9,34,-25,46,8.7,2023-2024
Niskanen Sami,Indians,27,4,2,6,6,27,23,4,31,12.9,2023-2024
Koljonen Perttu,Happee,24,5,1,6,4,14,18,-4,49,10.2,2023-2024
Pirhonen Elias,ErVi,33,0,5,5,0,39,62,-23,55,0.0,2023-2024
Laakso Markus,Oilers,33,0,5,5,0,0,0,0,0,-,2023-2024
Mertaniemi Väinö,OLS,29,1,4,5,6,20,36,-16,34,2.9,2023-2024
Repo Juho,SPV,25,1,4,5,0,16,19,-3,26,3.8,2023-2024
Saarela Miko,Jymy,32,2,3,5,14,27,46,-19,16,12.5,2023-2024
Wikström Roope,Jymy,31,2,3,5,4,25,36,-11,29,6.9,2023-2024
Hutzli Stefan,Happee,27,2,3,5,0,32,33,-1,30,6.7,2023-2024
Tiainen Tuomas,ErVi,33,3,2,5,10,11,35,-24,28,10.7,2023-2024
Järvinen Perttu,Oilers,30,3,2,5,4,23,17,6,26,11.5,2023-2024
Forss Onni,Indians,22,3,2,5,0,31,9,22,13,23.1,2023-2024
Lokasaari Aapo,SPV,32,4,1,5,6,27,23,4,39,10.3,2023-2024
Varjokumpu Juuso,FBC,31,0,4,4,0,29,78,-49,57,0.0,2023-2024
Pentikäinen Miikka,LASB,31,0,4,4,34,22,52,-30,19,0.0,2023-2024
Hakala Tommi,Jymy,30,1,3,4,2,22,33,-11,45,2.2,2023-2024
Vähäkangas Johannes,FBC,29,1,3,4,8,15,50,-35,41,2.4,2023-2024
Salokangas Julius,LASB,28,1,3,4,0,21,40,-19,30,3.3,2023-2024
Lindstedt Tino,LASB,23,1,3,4,0,9,16,-7,10,10.0,2023-2024
Harmaala Aatu,LASB,12,1,3,4,0,6,10,-4,29,3.4,2023-2024
Talvitie Ilari,Oilers,20,2,2,4,0,32,15,17,32,6.3,2023-2024
Hämäläinen Miika,FBC,19,2,2,4,0,12,24,-12,7,28.6,2023-2024
Ahola Vili,LASB,30,0,3,3,0,18,54,-36,28,0.0,2023-2024
Honkonen Arttu,SPV,27,0,3,3,0,16,12,4,4,0.0,2023-2024
Larte Joona,Oilers,23,0,3,3,0,22,16,6,11,0.0,2023-2024
Kuisma Niklas,Happee,32,1,2,3,4,15,20,-5,23,4.3,2023-2024
Rannanjärvi Jaakko,FBC,30,1,2,3,2,18,58,-40,58,1.7,2023-2024
Salminen Sami,LASB,26,1,2,3,0,9,14,-5,16,6.3,2023-2024
Laine Lauri,FBC,20,1,2,3,4,14,42,-28,22,4.5,2023-2024
Nyman Alexander,SPV,15,1,2,3,6,13,9,4,7,14.3,2023-2024
Rantala Peetu,LASB,31,2,1,3,6,10,36,-26,21,9.5,2023-2024
Virtanen Viljami,Classic,25,2,1,3,0,12,7,5,14,14.3,2023-2024
Haudanlampi Tuukka,OLS,13,2,1,3,4,6,15,-9,6,33.3,2023-2024
Lähdesmäki Lassi,FBC,10,2,1,3,2,4,9,-5,11,18.2,2023-2024
Haapala Arttu,Oilers,9,2,1,3,2,7,7,0,12,16.7,2023-2024
Salminen Olli,ErVi,5,2,1,3,0,4,11,-7,11,18.2,2023-2024
Karkulowski Emil,LASB,26,3,0,3,2,14,34,-20,28,10.7,2023-2024
Virolainen Luukas,OLS,13,3,0,3,0,2,16,-14,13,23.1,2023-2024
Karjalainen Aki,Jymy,32,0,2,2,4,0,1,-1,0,-,2023-2024
Ojanperä Aleksi,Jymy,24,0,2,2,2,4,10,-6,5,0.0,2023-2024
Koistinen Eero,ErVi,19,0,2,2,2,2,12,-10,11,0.0,2023-2024
Kärki Santeri,ErVi,18,0,2,2,2,3,12,-9,11,0.0,2023-2024
Mäenpää Eero,Jymy,14,0,2,2,4,7,12,-5,7,0.0,2023-2024
Hoikkala Jussi,FBC,10,0,2,2,4,9,25,-16,6,0.0,2023-2024
Hiltunen Aleksi,FBC,33,1,1,2,8,22,63,-41,20,5.0,2023-2024
Palvaila Lauri,Oilers,29,1,1,2,6,29,17,12,18,5.6,2023-2024
Moislahti Rasmus,FBC,27,1,1,2,4,17,32,-15,13,7.7,2023-2024
Laukkanen Jarno,KrP,18,1,1,2,2,5,4,1,6,16.7,2023-2024
Haavisto Aapo,SPV,13,1,1,2,2,7,5,2,1,100.0,2023-2024
Junkkari Jonatan,Indians,11,1,1,2,0,7,3,4,5,20.0,2023-2024
Aho Tuomas,ErVi,7,1,1,2,6,1,8,-7,9,11.1,2023-2024
Harjula Eero,Indians,2,1,1,2,0,3,0,3,1,100.0,2023-2024
Rantala Juho,LASB,23,2,0,2,0,4,30,-26,29,6.9,2023-2024
Koivisto Aatu,TPS,17,2,0,2,0,7,11,-4,19,10.5,2023-2024
Okkonen Roope,OLS,11,2,0,2,0,12,15,-3,9,22.2,2023-2024
Kirvesniemi Mikko,Indians,33,0,1,1,0,0,1,-1,1,0.0,2023-2024
Kantonen Kasperi,TPS,32,0,1,1,0,3,2,1,5,0.0,2023-2024
Rantaniemi Iiro,OLS,31,0,1,1,0,0,0,0,0,-,2023-2024
Toriseva Lassi,Classic,30,0,1,1,4,1,0,1,0,-,2023-2024
Panuma Riku,OLS,27,0,1,1,0,0,0,0,0,-,2023-2024
Pohjonen Santtu,LASB,25,0,1,1,0,0,0,0,0,-,2023-2024
Tuononen Roni,KrP,24,0,1,1,0,0,0,0,0,-,2023-2024
Salo Tuukka,Classic,23,0,1,1,2,10,9,1,11,0.0,2023-2024
Vaajala Matias,Classic,20,0,1,1,0,4,11,-7,13,0.0,2023-2024
Kriz Lukas,ErVi,20,0,1,1,2,0,0,0,0,-,2023-2024
Fredriksson Mikael,FBC,20,0,1,1,4,5,13,-8,11,0.0,2023-2024
Sedin Willy,TPS,17,0,1,1,0,12,11,1,12,0.0,2023-2024
Ranta Justus,Jymy,15,0,1,1,2,7,10,-3,10,0.0,2023-2024
Kareinen Miikka,Indians,13,0,1,1,0,6,5,1,4,0.0,2023-2024
Auvinen Otso,Classic,9,0,1,1,0,0,0,0,0,-,2023-2024
Ainoa Luka,KrP,8,0,1,1,0,5,3,2,0,-,2023-2024
Sieppi Julius,Happee,7,0,1,1,0,3,1,2,0,-,2023-2024
Mustonen Justus,Oilers,7,0,1,1,0,2,2,0,2,0.0,2023-2024
Helin Niilo,Classic,7,0,1,1,0,1,1,0,2,0.0,2023-2024
Jäppinen Amos,ErVi,33,1,0,1,14,11,52,-41,27,3.7,2023-2024
Vaarimo Miko,ErVi,32,1,0,1,4,4,30,-26,26,3.8,2023-2024
Holappa Niko-Petteri,OLS,31,1,0,1,0,23,30,-7,12,8.3,2023-2024
Ilmivalta Topias,FBC,26,1,0,1,0,10,36,-26,13,7.7,2023-2024
Hirvisuo Heikki,TPS,25,1,0,1,2,8,16,-8,9,11.1,2023-2024
Mustonen Juho,OLS,21,1,0,1,0,2,6,-4,8,12.5,2023-2024
Ondruschka Ferdinand,Jymy,17,1,0,1,8,4,7,-3,15,6.7,2023-2024
Karjanlahti Eemeli,SPV,13,1,0,1,2,8,15,-7,11,9.1,2023-2024
Tenho Oskari,KrP,11,1,0,1,0,2,4,-2,9,11.1,2023-2024
Rissanen Aarne,ErVi,9,1,0,1,0,1,6,-5,8,12.5,2023-2024
Kajaala Joona,SPV,8,1,0,1,0,1,1,0,2,50.0,2023-2024
Markkanen Jami,Happee,7,1,0,1,2,2,3,-1,5,20.0,2023-2024
Siekkinen Paavo,Happee,6,1,0,1,0,1,2,-1,3,33.3,2023-2024
Lallukka Ossi,SPV,33,0,0,0,0,0,0,0,0,-,2023-2024
Kuisma Olli,TPS,33,0,0,0,0,0,0,0,0,-,2023-2024
Jokisalo Juuso,Indians,33,0,0,0,0,0,0,0,1,0.0,2023-2024
Sillanpää Oskar,Classic,32,0,0,0,0,0,0,0,0,-,2023-2024
Laakso Elmeri,FBC,32,0,0,0,0,0,0,0,0,-,2023-2024
Jääskeläinen Pietari,Happee,32,0,0,0,2,0,0,0,0,-,2023-2024
Hellsten Rasmus,Oilers,32,0,0,0,0,0,1,-1,0,-,2023-2024
Hasu Rasmus,SPV,32,0,0,0,0,1,0,1,1,0.0,2023-2024
Hanousek Martin,Jymy,32,0,0,0,0,0,0,0,0,-,2023-2024
Aaltokallio Miika,Happee,32,0,0,0,0,0,0,0,0,-,2023-2024
Tuomala Miro,KrP,31,0,0,0,0,0,0,0,0,-,2023-2024
Fälden Oskari,TPS,31,0,0,0,0,1,1,0,0,-,2023-2024
Molkka Valtteri,Classic,30,0,0,0,0,0,4,-4,9,0.0,2023-2024
Beijar Jens,FBC,30,0,0,0,0,0,0,0,1,0.0,2023-2024
Järvinen Pasi,LASB,27,0,0,0,0,0,1,-1,0,-,2023-2024
Lehto Väinö,ErVi,20,0,0,0,0,0,0,0,0,-,2023-2024
Kulmala Kasper,TPS,15,0,0,0,0,0,4,-4,2,0.0,2023-2024
Maksimainen Olli,ErVi,14,0,0,0,0,3,9,-6,5,0.0,2023-2024
Rantala Leevi,ErVi,13,0,0,0,0,0,0,0,0,-,2023-2024
Niemelä Oliver,TPS,13,0,0,0,2,0,4,-4,6,0.0,2023-2024
Koivisto Aatu,FBC,13,0,0,0,0,3,9,-6,8,0.0,2023-2024
Ojala Touko,ErVi,12,0,0,0,2,0,0,0,0,-,2023-2024
Mertsalmi Henri,LASB,11,0,0,0,0,0,1,-1,1,0.0,2023-2024
Huhtakallio Eemeli,Classic,11,0,0,0,0,1,2,-1,2,0.0,2023-2024
Korhonen Teemu,LASB,10,0,0,0,0,0,0,0,2,0.0,2023-2024
Saarinen Miki,KrP,9,0,0,0,0,0,0,0,0,-,2023-2024
Andersson Robin,ErVi,9,0,0,0,0,0,0,0,0,-,2023-2024
Roimela Setti,Indians,8,0,0,0,0,0,2,-2,1,0.0,2023-2024
Mäntyniemi Jimi,Jymy,8,0,0,0,0,2,8,-6,5,0.0,2023-2024
Mäkimarttunen Saku,KrP,8,0,0,0,0,0,1,-1,3,0.0,2023-2024
Vänttinen Oliver,Classic,7,0,0,0,0,1,2,-1,4,0.0,2023-2024
Tuominen Niklas,ErVi,7,0,0,0,0,3,6,-3,3,0.0,2023-2024
Kuoksa Antti,OLS,7,0,0,0,0,0,3,-3,1,0.0,2023-2024
Luukko Joona,Jymy,6,0,0,0,0,0,1,-1,1,0.0,2023-2024
Paananen Joel,Happee,5,0,0,0,0,3,0,3,0,-,2023-2024
Maronen Markus,Indians,5,0,0,0,0,0,1,-1,1,0.0,2023-2024
Siira Jami,OLS,4,0,0,0,0,0,0,0,0,-,2023-2024
Manninen Eetu,Jymy,4,0,0,0,0,0,0,0,0,-,2023-2024
Kivelä Ville,OLS,4,0,0,0,0,0,0,0,1,0.0,2023-2024
Kantola Karo,LASB,4,0,0,0,0,1,1,0,2,0.0,2023-2024
Kallio Emil,Oilers,4,0,0,0,0,0,0,0,0,-,2023-2024
Halmela Teemu,KrP,4,0,0,0,0,1,1,0,4,0.0,2023-2024
Aro Konsta,KrP,4,0,0,0,0,1,0,1,0,-,2023-2024
Sirola Aku,LASB,3,0,0,0,0,0,0,0,0,-,2023-2024
Niemelä Eetu,Oilers,3,0,0,0,2,3,2,1,3,0.0,2023-2024
Luhtala Aatu,SPV,3,0,0,0,0,0,0,0,0,-,2023-2024
Koskinen Valtteri,TPS,3,0,0,0,0,2,0,2,0,-,2023-2024
Huppunen Julius-Emil,Indians,3,0,0,0,0,1,0,1,0,-,2023-2024
Zlesák Ondřej,Oilers,2,0,0,0,0,0,0,0,0,-,2023-2024
Schroderus Tobias,OLS,2,0,0,0,0,0,0,0,0,-,2023-2024
Saarikko Sami,KrP,2,0,0,0,0,0,0,0,0,-,2023-2024
Pokela Matias,Jymy,2,0,0,0,0,0,0,0,0,-,2023-2024
Piisilä Oskari,Indians,2,0,0,0,0,0,0,0,0,-,2023-2024
Paajanen Veikko,TPS,2,0,0,0,0,0,1,-1,0,-,2023-2024
Mankinen Arttu,TPS,2,0,0,0,0,0,0,0,0,-,2023-2024
Kakko Tuomas,OLS,2,0,0,0,0,0,0,0,0,-,2023-2024
Johansson Jerry,FBC,2,0,0,0,0,0,0,0,0,-,2023-2024
Häkkinen Aapo,Happee,2,0,0,0,0,0,0,0,0,-,2023-2024
Honkanen Tobias,FBC,2,0,0,0,0,0,0,0,0,-,2023-2024
Hallbäck Marek,FBC,2,0,0,0,0,0,0,0,0,-,2023-2024
Eskelinen Joni,OLS,2,0,0,0,0,0,0,0,0,-,2023-2024
Ekuri Joonas,TPS,2,0,0,0,0,0,0,0,0,-,2023-2024
Aho Heikki,FBC,2,0,0,0,0,0,0,0,0,-,2023-2024
Soininen Mirko,Jymy,1,0,0,0,0,0,0,0,0,-,2023-2024
Ryytty Valtteri,LASB,1,0,0,0,0,0,0,0,0,-,2023-2024
Rokala Oliver,TPS,1,0,0,0,0,0,0,0,0,-,2023-2024
Rautio Severi,TPS,1,0,0,0,0,0,0,0,0,-,2023-2024
Partanen Elias,KrP,1,0,0,0,0,0,0,0,0,-,2023-2024
Niemi Lauri,OLS,1,0,0,0,0,0,0,0,0,-,2023-2024
Markkula Tuomas,Oilers,1,0,0,0,0,0,0,0,0,-,2023-2024
Liukkonen Teppo,SPV,1,0,0,0,0,0,0,0,0,-,2023-2024
Lepojärvi Eemeli,OLS,1,0,0,0,0,0,0,0,0,-,2023-2024
Lehtinen Jami,TPS,1,0,0,0,0,0,0,0,0,-,2023-2024
Laine Ville-Martti,Jymy,1,0,0,0,0,1,2,-1,1,0.0,2023-2024
Jaaranen Dani,KrP,1,0,0,0,0,3,2,1,3,0.0,2023-2024
Hämäläinen Veeti,LASB,1,0,0,0,0,0,0,0,0,-,2023-2024
Heinonen Valtteri,Oilers,1,0,0,0,0,0,0,0,1,0.0,2023-2024
Hakokorpi Pietu,Oilers,1,0,0,0,0,0,0,0,0,-,2023-2024
Grönfors Samuli,Happee,1,0,0,0,0,0,0,0,0,-,2023-2024
Eronen Aaro,TPS,1,0,0,0,0,0,0,0,0,-,2023-2024
Kotilainen Peter,SPV,32,29,44,73,16,102,47,55,354,8.2,2022-2023
Kailiala Miko,TPS,33,46,24,70,6,110,61,49,237,19.4,2022-2023
Iiskola Heikki,Oilers,31,34,33,67,12,112,50,62,208,16.3,2022-2023
Laakso Mikko,KrP,33,32,31,63,8,112,62,50,154,20.8,2022-2023
Johansson Sami,Classic,32,38,22,60,12,103,60,43,292,13.0,2022-2023
Hautaniemi Mikko,TPS,32,48,12,60,2,109,41,68,232,20.7,2022-2023
Rantala Joona,KrP,33,32,27,59,14,116,74,42,207,15.5,2022-2023
Kainulainen Justus,Oilers,32,38,21,59,12,122,64,58,386,9.8,2022-2023
Johansson Henri,KrP,31,32,25,57,2,102,57,45,124,25.8,2022-2023
Lund Joakim,ErVi,26,21,29,50,14,76,80,-4,196,10.7,2022-2023
Remes Christian,Indians,33,26,24,50,2,83,62,21,190,13.7,2022-2023
Hyvärinen Luukas,OLS,31,23,26,49,12,81,61,20,134,17.2,2022-2023
Astala Aaro,Oilers,27,24,25,49,8,95,32,63,176,13.6,2022-2023
Manninen Jami,Happee,33,23,25,48,14,93,73,20,196,11.7,2022-2023
Siekkinen Kaapo,Happee,33,34,13,47,14,97,51,46,158,21.5,2022-2023
Haveri Elmeri,Jymy,33,32,14,46,10,78,88,-10,255,12.5,2022-2023
Trekse Peteris,TPS,33,17,28,45,26,103,50,53,162,10.5,2022-2023
Laiti Niko,Happee,33,24,21,45,0,84,44,40,151,15.9,2022-2023
Salmi Markus,Happee,32,26,19,45,14,97,44,53,216,12.0,2022-2023
Lastikka Ville,Classic,24,20,24,44,2,81,36,45,158,12.7,2022-2023
Salin Eemeli,Classic,23,26,18,44,10,73,35,38,175,14.9,2022-2023
Sieppi Joni-Arttu,OLS,31,29,15,44,6,75,65,10,198,14.6,2022-2023
Kovanen Joonatan,KrP,31,26,17,43,8,101,61,40,164,15.9,2022-2023
Haukkala Konsta,SPV,33,31,12,43,24,99,57,42,215,14.4,2022-2023
Koski Sami,SPV,32,8,34,42,4,65,31,34,93,8.6,2022-2023
Hankkio Jari,Jymy,30,22,20,42,22,69,52,17,226,9.7,2022-2023
Rosendahl Tommi,ErVi,26,17,23,40,2,72,76,-4,105,16.2,2022-2023
Hakanen Riku,Jymy,24,23,17,40,6,69,63,6,172,13.4,2022-2023
Koskinen Albert,Classic,33,25,15,40,10,85,40,45,190,13.2,2022-2023
Vesterinen Waltteri,TPS,29,14,24,38,10,75,31,44,117,12.0,2022-2023
Heikkilä Oskari,Classic,33,15,23,38,6,81,52,29,136,11.0,2022-2023
Jonaeson Nico,KrP,31,17,20,37,8,96,48,48,104,16.3,2022-2023
Niemelä Jere,TPS,25,20,17,37,18,80,41,39,147,13.6,2022-2023
Markkola Markus,Oilers,26,19,17,36,12,63,31,32,104,18.3,2022-2023
Sipronen Markus,Happee,33,10,23,33,4,92,58,34,89,11.2,2022-2023
Ahola Juuso,KrP,30,19,14,33,6,67,35,32,112,17.0,2022-2023
Kinnunen Teuvo,Happee,30,17,15,32,2,50,24,26,123,13.8,2022-2023
Karvonen Valte,OLS,30,17,15,32,2,73,57,16,86,19.8,2022-2023
Iiskola Tuomas,Oilers,28,16,15,31,14,75,34,41,126,12.7,2022-2023
Viitakoski Valtteri,KrP,33,22,9,31,2,71,47,24,119,18.5,2022-2023
Kinnunen Olli,OLS,31,22,9,31,8,85,82,3,127,17.3,2022-2023
Laitila Alpo,Classic,33,6,24,30,6,72,48,24,54,11.1,2022-2023
Laine Olli-Akseli,TPS,33,11,19,30,14,83,37,46,120,9.2,2022-2023
Einiö Niko,LASB,33,25,5,30,12,68,83,-15,236,10.6,2022-2023
Havula Tatu,LASB,32,13,16,29,4,68,98,-30,99,13.1,2022-2023
Minkkinen Matti,Happee,28,18,11,29,2,62,37,25,144,12.5,2022-2023
Ollikainen Aaro,FBC,32,20,9,29,16,54,97,-43,140,14.3,2022-2023
Junnila Samuli,Indians,29,8,19,27,10,59,47,12,130,6.2,2022-2023
Huppunen Jesse-Samuli,Indians,33,11,16,27,6,93,74,19,107,10.3,2022-2023
Auvinen Jasper,Indians,23,17,10,27,6,57,41,16,131,13.0,2022-2023
Laaksonen Nikolas,FBC,33,10,16,26,10,66,115,-49,109,9.2,2022-2023
Surakka Joonatan,LASB,31,10,16,26,6,57,90,-33,121,8.3,2022-2023
Lindfors Santeri,Oilers,33,15,11,26,10,58,55,3,103,14.6,2022-2023
Pelto-Arvo Jukka-Pekka,SPV,32,18,8,26,4,63,54,9,104,17.3,2022-2023
Tykkyläinen Konsta,Classic,33,19,7,26,8,75,49,26,129,14.7,2022-2023
Äijälä Niklas,Jymy,33,13,12,25,2,61,60,1,68,19.1,2022-2023
Ojala Tuomas,TPS,33,14,11,25,6,77,40,37,96,14.6,2022-2023
Kainulainen Valtteri,Indians,30,15,10,25,0,56,60,-4,123,12.2,2022-2023
Laasonen Roni,Happee,33,17,8,25,12,65,45,20,125,13.6,2022-2023
Majer Petr,Indians,31,18,7,25,0,46,27,19,138,13.0,2022-2023
Juuti Jasper,LASB,29,12,12,24,10,51,66,-15,158,7.6,2022-2023
Veikkola Matias,Oilers,32,13,11,24,4,123,68,55,67,19.4,2022-2023
Kauppinen Pyry,FBC,21,13,11,24,30,37,60,-23,123,10.6,2022-2023
Sillanpää Oliver,ErVi,22,16,8,24,6,49,68,-19,122,13.1,2022-2023
Keskinen Juuso,SPV,32,18,6,24,14,65,44,21,174,10.3,2022-2023
Moilanen Mika,ErVi,16,19,5,24,4,40,34,6,86,22.1,2022-2023
Suomela Antti,Oilers,32,9,14,23,2,114,60,54,63,14.3,2022-2023
Hirvisuo Ville,TPS,32,9,14,23,10,87,56,31,81,11.1,2022-2023
Auranen Leevi,Indians,30,13,10,23,0,60,62,-2,107,12.1,2022-2023
Salokangas Tiitus,LASB,24,14,9,23,16,45,46,-1,107,13.1,2022-2023
Krumins Morics,KrP,29,9,13,22,10,85,52,33,77,11.7,2022-2023
Sikkinen Eetu,Classic,23,9,12,21,8,62,34,28,56,16.1,2022-2023
Paulaharju Simo,KrP,31,11,10,21,4,39,22,17,75,14.7,2022-2023
Välitalo Anssi,OLS,33,8,12,20,2,51,69,-18,44,18.2,2022-2023
Harjula Tuomas,Indians,33,8,12,20,2,53,56,-3,40,20.0,2022-2023
Salminen Toni,Classic,33,10,10,20,2,76,55,21,67,14.9,2022-2023
Hyrkkönen Kim,KrP,32,13,7,20,12,44,33,11,71,18.3,2022-2023
Karjanlahti Eero,SPV,33,15,5,20,16,48,49,-1,101,14.9,2022-2023
Suhanto Eppu,Happee,33,4,15,19,4,78,54,24,106,3.8,2022-2023
Arkkila Olli,KrP,31,9,10,19,14,55,32,23,58,15.5,2022-2023
Forsman Juuso,FBC,24,9,10,19,10,44,68,-24,153,5.9,2022-2023
Koljonen Perttu,Happee,32,10,9,19,2,60,49,11,128,7.8,2022-2023
Pasanen Rasmus,Indians,23,10,9,19,16,54,37,17,70,14.3,2022-2023
Eklund Alex,ErVi,30,12,7,19,2,20,38,-18,76,15.8,2022-2023
Hietaranta Ville,Classic,31,14,5,19,2,41,26,15,71,19.7,2022-2023
Mäenpää Matias,Jymy,31,15,4,19,4,46,52,-6,109,13.8,2022-2023
Kekki Juuso,Indians,31,7,11,18,4,37,28,9,85,8.2,2022-2023
Lokasaari Aapo,SPV,33,11,7,18,2,72,50,22,105,10.5,2022-2023
Tenhonen Daniel,ErVi,33,14,4,18,10,32,74,-42,83,16.9,2022-2023
Niemelä Oliver,FBC,27,14,4,18,4,22,39,-17,107,13.1,2022-2023
Ijäs Eetu,OLS,31,6,11,17,18,61,66,-5,75,8.0,2022-2023
Alatalo Pieti,Indians,33,7,10,17,10,44,27,17,61,11.5,2022-2023
Niskanen Sami,Indians,30,9,8,17,8,36,47,-11,42,21.4,2022-2023
Lamminen Kristian,Oilers,30,9,8,17,6,33,24,9,101,8.9,2022-2023
Tuononen verneri,FBC,25,13,4,17,10,27,59,-32,78,16.7,2022-2023
Vänttilä Kimi,OLS,20,3,13,16,4,44,40,4,32,9.4,2022-2023
Lindfors Jesperi,Oilers,33,5,11,16,10,65,49,16,58,8.6,2022-2023
Palvaila Lauri,LASB,33,6,10,16,2,54,91,-37,64,9.4,2022-2023
Arola Jesse,LASB,32,9,7,16,4,36,64,-28,90,10.0,2022-2023
Uusi-Laitila Santeri,SPV,33,5,10,15,8,67,48,19,80,6.3,2022-2023
Harjula Eero,Indians,33,6,9,15,2,37,41,-4,73,8.2,2022-2023
Tammiranta Aaro,SPV,26,6,9,15,10,23,30,-7,45,13.3,2022-2023
Niemelä Petri,OLS,30,7,8,15,6,30,32,-2,51,13.7,2022-2023
Salo Nico,Classic,19,7,8,15,2,56,28,28,61,11.5,2022-2023
Autio Janne,SPV,33,8,7,15,2,44,55,-11,44,18.2,2022-2023
Parviainen Valtteri,OLS,24,8,7,15,0,45,33,12,89,9.0,2022-2023
Perälä Niko-Arttu,Jymy,29,9,6,15,30,46,60,-14,57,15.8,2022-2023
Vaajala Matias,Classic,32,10,5,15,2,44,22,22,66,15.2,2022-2023
Kuusela Ville-Pertti,SPV,33,15,0,15,4,43,44,-1,70,21.4,2022-2023
Wikstedt Olli,OLS,28,3,11,14,4,54,73,-19,60,5.0,2022-2023
Stenfors Lauri,TPS,32,7,7,14,6,68,54,14,34,20.6,2022-2023
Sariola Eetu,Jymy,32,8,6,14,30,70,71,-1,129,6.2,2022-2023
Ukkonen Eemil,KrP,31,2,11,13,8,62,49,13,37,5.4,2022-2023
Järvikangas Viljami,Jymy,28,2,11,13,14,49,60,-11,26,7.7,2022-2023
Kukkola Jani,ErVi,29,5,8,13,6,67,84,-17,89,5.6,2022-2023
Akola Eemeli,Classic,33,6,7,13,12,72,51,21,37,16.2,2022-2023
Juuranto Matias,Oilers,32,6,7,13,14,23,37,-14,74,8.1,2022-2023
Hoikkanen Janne,TPS,14,7,6,13,2,29,14,15,35,20.0,2022-2023
Pietinen Matias,LASB,33,8,5,13,10,29,41,-12,57,14.0,2022-2023
Alatorvinen Joona,ErVi,33,8,5,13,2,29,40,-11,56,14.3,2022-2023
Ruonakangas Riku,OLS,28,8,5,13,8,31,45,-14,83,9.6,2022-2023
Rauhala Jani,Indians,24,8,5,13,16,49,42,7,80,10.0,2022-2023
Sulander Jere,LASB,31,10,3,13,0,20,34,-14,57,17.5,2022-2023
Junkkarinen Jonne,Happee,32,3,9,12,6,88,60,28,44,6.8,2022-2023
Tuominen Sami,FBC,27,3,9,12,0,31,63,-32,63,4.8,2022-2023
Tenhonen Benjamin,ErVi,33,5,7,12,4,27,62,-35,45,11.1,2022-2023
Saari Arttu,Jymy,32,5,7,12,18,52,70,-18,44,11.4,2022-2023
Heikkinen Juuso,Happee,31,6,6,12,8,30,36,-6,35,17.1,2022-2023
Laine Lauri,FBC,30,8,4,12,4,38,96,-58,77,10.4,2022-2023
Storgårds Erik,TPS,33,3,8,11,10,76,41,35,31,9.7,2022-2023
Karjanlahti Eemeli,Jymy,16,5,6,11,0,29,28,1,36,13.9,2022-2023
Kilpi Otto,Classic,26,7,4,11,8,33,23,10,51,13.7,2022-2023
Heikkilä Jeri,SPV,32,8,3,11,0,46,40,6,63,12.7,2022-2023
Santanen Mikko,SPV,33,3,7,10,0,48,64,-16,28,10.7,2022-2023
Latvala Miika,SPV,33,3,7,10,14,42,53,-11,53,5.7,2022-2023
Virrankari Olli-Matti,OLS,33,4,6,10,24,49,64,-15,30,13.3,2022-2023
Pylväläinen Arttu,Happee,33,7,3,10,8,33,25,8,43,16.3,2022-2023
Lindholm Joonatan,Indians,31,8,2,10,26,54,65,-11,62,12.9,2022-2023
Rautio Petro,Jymy,33,0,9,9,0,44,60,-16,21,0.0,2022-2023
Laitinen Patrik,ErVi,33,2,7,9,4,32,68,-36,42,4.8,2022-2023
Mäkinen Miska,KrP,11,2,7,9,0,26,13,13,9,22.2,2022-2023
Harle Teemu,OLS,29,3,6,9,2,36,70,-34,58,5.2,2022-2023
Lillas Didrik,SPV,33,4,5,9,0,24,29,-5,40,10.0,2022-2023
Leikkanen Mikko,Classic,12,4,5,9,0,36,18,18,28,14.3,2022-2023
Hakola Jesper,OLS,23,5,4,9,8,18,33,-15,42,11.9,2022-2023
Roth Anton,Indians,32,6,3,9,8,18,16,2,38,15.8,2022-2023
Hakala Tommi,Jymy,33,7,2,9,0,26,66,-40,55,12.7,2022-2023
Lindstedt Tino,LASB,33,1,7,8,6,43,69,-26,16,6.3,2022-2023
Pentikäinen Miikka,LASB,20,1,7,8,4,26,30,-4,17,5.9,2022-2023
Puolakka Joni,LASB,21,2,6,8,0,26,39,-13,11,18.2,2022-2023
Hoikkala Jussi,FBC,32,3,5,8,8,38,86,-48,68,4.4,2022-2023
Havia Aleksi,FBC,32,3,5,8,8,41,91,-50,35,8.6,2022-2023
Vuoristo Santtu,ErVi,30,3,5,8,2,28,50,-22,37,8.1,2022-2023
Pekari Elias,Oilers,32,4,4,8,6,19,18,1,37,10.8,2022-2023
Hopeanaula Antti,FBC,33,5,3,8,6,33,81,-48,42,11.9,2022-2023
Puntanen Eetu,Jymy,30,5,3,8,6,26,58,-32,58,8.6,2022-2023
Möttönen Juuso,ErVi,31,6,2,8,0,21,39,-18,43,14.0,2022-2023
Talvitie Ilari,Oilers,29,7,1,8,4,36,23,13,69,10.1,2022-2023
Ailio Tuure,Oilers,29,1,6,7,4,27,27,0,41,2.4,2022-2023
Ahokas Aleksi,TPS,10,1,6,7,0,12,13,-1,14,7.1,2022-2023
Hautamäki Jaakko,TPS,33,2,5,7,2,18,23,-5,15,13.3,2022-2023
Pulkkinen Jere,Classic,20,2,5,7,0,20,16,4,13,15.4,2022-2023
Virtanen Viljami,Classic,17,2,5,7,0,20,14,6,11,18.2,2022-2023
Molkka Valtteri,Classic,32,3,4,7,0,11,11,0,19,15.8,2022-2023
Karkulowski Emil,LASB,23,3,4,7,0,14,20,-6,15,20.0,2022-2023
Siira Elias,FBC,19,3,4,7,4,21,47,-26,33,9.1,2022-2023
Turula Veli-Pekka,ErVi,28,4,3,7,2,27,50,-23,65,6.2,2022-2023
Karjula Joona,OLS,12,5,2,7,0,12,9,3,29,17.2,2022-2023
Heiska Ville,Happee,12,6,1,7,0,8,8,0,30,20.0,2022-2023
Wiander Tommi,Happee,30,0,6,6,6,27,34,-7,20,0.0,2022-2023
Mattila Jere,KrP,23,0,6,6,6,50,42,8,47,0.0,2022-2023
Aarela Ilmari,Happee,32,2,4,6,4,23,25,-2,42,4.8,2022-2023
Huppunen Julius-Emil,FBC,6,2,4,6,2,14,20,-6,19,10.5,2022-2023
Alkki Lauri,KrP,33,3,3,6,4,61,53,8,26,11.5,2022-2023
Lamminen Janne,Classic,22,3,3,6,6,40,43,-3,38,7.9,2022-2023
Harmaala Aatu,LASB,14,3,3,6,26,9,10,-1,29,10.3,2022-2023
Pöyhtäri Akseli,OLS,6,3,3,6,0,7,5,2,13,23.1,2022-2023
Repo Juho,SPV,28,4,2,6,0,17,31,-14,43,9.3,2022-2023
Vaarala Kalle,Jymy,26,4,2,6,10,22,50,-28,65,6.2,2022-2023
Koskinen Joonas,TPS,22,4,2,6,0,12,14,-2,28,14.3,2022-2023
Salokangas Julius,LASB,24,5,1,6,4,16,30,-14,34,14.7,2022-2023
Wikström Roope,LASB,31,6,0,6,4,19,43,-24,29,20.7,2022-2023
Karjalainen Aki,Jymy,31,0,5,5,0,0,1,-1,0,-,2022-2023
Hirsikorpi Mika,OLS,29,1,4,5,6,9,33,-24,24,4.2,2022-2023
Viitanen Joonas,FBC,32,2,3,5,6,24,67,-43,47,4.3,2022-2023
Jalonen Ossi,ErVi,30,2,3,5,4,66,86,-20,64,3.1,2022-2023
Raappana Atte,LASB,26,2,3,5,4,23,35,-12,25,8.0,2022-2023
Juselius Marko,Oilers,26,2,3,5,4,30,25,5,59,3.4,2022-2023
Koivisto Lassi,ErVi,22,2,3,5,2,19,27,-8,37,5.4,2022-2023
Salonen Janne,EräViikingit,20,2,3,5,4,24,33,-9,18,11.1,2022-2023
Kallio Matias,FBC,29,3,2,5,4,14,42,-28,42,7.1,2022-2023
Jaanus Janne,LASB,25,3,2,5,0,30,47,-17,25,12.0,2022-2023
Forss Onni,Indians,19,3,2,5,2,26,18,8,12,25.0,2022-2023
Liponen Saku,ErVi,30,4,1,5,4,13,33,-20,28,14.3,2022-2023
Mertaniemi Väinö,OLS,21,5,0,5,4,16,35,-19,31,16.1,2022-2023
Koivisto Veeti,OLS,17,5,0,5,4,7,9,-2,30,16.7,2022-2023
Virolainen Luukas,OLS,11,5,0,5,0,14,24,-10,27,18.5,2022-2023
Sokka Miikka,TPS,10,0,4,4,0,20,12,8,8,0.0,2022-2023
Simonen Topias,KrP,31,1,3,4,2,29,20,9,28,3.6,2022-2023
Viitala Lauri,Happee,30,1,3,4,6,12,16,-4,13,7.7,2022-2023
Hiltunen Aleksi,FBC,30,1,3,4,6,17,58,-41,22,4.5,2022-2023
Heiskanen Joona,FBC,28,1,3,4,6,6,33,-27,39,2.6,2022-2023
Hämäläinen Miika,FBC,26,1,3,4,2,14,40,-26,22,4.5,2022-2023
Järvinen Perttu,ErVi,20,1,3,4,2,26,38,-12,33,3.0,2022-2023
Lintula Matias,SPV,33,2,2,4,8,33,46,-13,26,7.7,2022-2023
Koistinen Eero,ErVi,16,2,2,4,0,10,11,-1,23,8.7,2022-2023
Kukko Joona,Jymy,7,2,2,4,4,14,15,-1,14,14.3,2022-2023
Jokela Olli,Oilers,28,3,1,4,4,16,22,-6,42,7.1,2022-2023
Kaltiainen Joonas,Oilers,33,0,3,3,4,0,0,0,1,0.0,2022-2023
Hämäläinen Petteri,Jymy,32,0,3,3,4,17,39,-22,25,0.0,2022-2023
Rodas Joel,FBC,28,0,3,3,2,18,42,-24,26,0.0,2022-2023
Eklund Emil,KrP,28,0,3,3,0,11,11,0,8,0.0,2022-2023
Vaarimo Miko,ErVi,5,0,3,3,0,7,15,-8,11,0.0,2022-2023
Kauppila Oskari,Jymy,31,1,2,3,8,4,32,-28,24,4.2,2022-2023
Lehtonen Konsta,LASB,25,1,2,3,4,8,26,-18,23,4.3,2022-2023
Maksimainen Olli,ErVi,21,1,2,3,4,9,25,-16,16,6.3,2022-2023
Jäppinen Amos,Indians,16,1,2,3,4,10,8,2,9,11.1,2022-2023
Kuoksa Antti,OLS,7,1,2,3,2,9,6,3,3,33.3,2022-2023
Hirvisuo Heikki,TPS,27,2,1,3,4,20,22,-2,19,10.5,2022-2023
Lintunen Teemu,FBC,26,2,1,3,0,9,28,-19,16,12.5,2022-2023
Tiira Lauri,OLS,24,2,1,3,8,26,52,-26,28,7.1,2022-2023
Suominen Marius,TPS,19,2,1,3,2,5,7,-2,13,15.4,2022-2023
Rantaniemi Aapo,OLS,16,2,1,3,4,18,40,-22,23,8.7,2022-2023
Markkula Tuomas,Oilers,12,2,1,3,0,5,0,5,5,40.0,2022-2023
Haapala Arttu,Oilers,9,2,1,3,0,7,3,4,13,15.4,2022-2023
Hasu Rasmus,SPV,32,0,2,2,2,0,0,0,0,-,2022-2023
Pohjonen Santtu,LASB,29,0,2,2,0,0,0,0,0,-,2022-2023
Rannanjärvi Jaakko,FBC,28,0,2,2,4,7,41,-34,31,0.0,2022-2023
Kotovaara Lassi,Happee,21,0,2,2,2,5,6,-1,8,0.0,2022-2023
Haataja Elias,TPS,9,0,2,2,0,2,2,0,5,0.0,2022-2023
Varjokumpu Juuso,TPS,33,1,1,2,0,10,15,-5,18,5.6,2022-2023
Honkaniemi Miikka,Jymy,31,1,1,2,0,7,33,-26,21,4.8,2022-2023
Koistinen Jere,KrP,28,1,1,2,0,4,12,-8,21,4.8,2022-2023
Tenho Oskari,KrP,17,1,1,2,0,4,3,1,8,12.5,2022-2023
Nurminen Janne,TPS,11,1,1,2,2,10,13,-3,7,14.3,2022-2023
Virtanen Jasper,Jymy,25,2,0,2,10,11,29,-18,15,13.3,2022-2023
Toriseva Lassi,Classic,32,0,1,1,12,0,0,0,1,0.0,2022-2023
Laakso Markus,Happee,31,0,1,1,14,0,0,0,1,0.0,2022-2023
Beijar Jens,FBC,31,0,1,1,0,0,0,0,0,-,2022-2023
Pollari Miika,Jymy,27,0,1,1,2,19,41,-22,10,0.0,2022-2023
Sillantaka Aleksi,FBC,25,0,1,1,0,0,0,0,1,0.0,2022-2023
Ranki Ville,LASB,25,0,1,1,2,9,23,-14,2,0.0,2022-2023
Kimpanpää Miika,Classic,18,0,1,1,0,8,11,-3,5,0.0,2022-2023
Helin Niilo,Classic,18,0,1,1,0,8,15,-7,6,0.0,2022-2023
Pensikkala Jarno,LASB,17,0,1,1,0,1,1,0,6,0.0,2022-2023
Niemelä Eetu,Oilers,16,0,1,1,0,1,5,-4,3,0.0,2022-2023
Koskinen Valtteri,TPS,15,0,1,1,2,4,3,1,5,0.0,2022-2023
Tuominen Niklas,ErVi,10,0,1,1,0,3,7,-4,3,0.0,2022-2023
Helin Vilho,Classic,10,0,1,1,4,9,3,6,14,0.0,2022-2023
Tiira Matias,OLS,5,0,1,1,0,4,6,-2,5,0.0,2022-2023
Nykänen Eetu,Indians,5,0,1,1,0,3,2,1,4,0.0,2022-2023
Honkonen Arttu,SPV,31,1,0,1,2,5,12,-7,7,14.3,2022-2023
Summanen Miko,Oilers,19,1,0,1,2,2,9,-7,7,14.3,2022-2023
Kareinen Miikka,Indians,17,1,0,1,4,10,11,-1,15,6.7,2022-2023
Tähkä Kasper,Happee,12,1,0,1,2,8,4,4,11,9.1,2022-2023
Rantala Leevi,Oilers,10,1,0,1,0,0,0,0,5,20.0,2022-2023
Vänttinen Oliver,Classic,7,1,0,1,0,2,3,-1,3,33.3,2022-2023
Sillanpää Oskar,Classic,33,0,0,0,4,0,0,0,0,-,2022-2023
Lallukka Ossi,ErVi,33,0,0,0,0,0,0,0,0,-,2022-2023
Kuisma Olli,TPS,33,0,0,0,0,0,0,0,0,-,2022-2023
Kantonen Kasperi,TPS,33,0,0,0,2,3,6,-3,19,0.0,2022-2023
Jokisalo Juuso,Indians,33,0,0,0,0,0,1,-1,0,-,2022-2023
Kivilompolo Vinski,OLS,32,0,0,0,0,0,0,0,0,-,2022-2023
Tuononen Roni,OLS,31,0,0,0,0,0,0,0,1,0.0,2022-2023
Nordström Niko,Oilers,31,0,0,0,0,0,0,0,0,-,2022-2023
Fälden Oskari,TPS,31,0,0,0,0,0,0,0,0,-,2022-2023
Sipilä Nemo,ErVi,30,0,0,0,0,0,0,0,0,-,2022-2023
Jääskeläinen Pietari,Happee,30,0,0,0,0,0,0,0,1,0.0,2022-2023
Järvinen Pasi,LASB,28,0,0,0,0,0,0,0,0,-,2022-2023
Saarinen Miki,KrP,27,0,0,0,0,0,0,0,1,0.0,2022-2023
Kirvesniemi Mikko,Indians,27,0,0,0,0,0,0,0,1,0.0,2022-2023
Savela Juho,OLS,26,0,0,0,0,11,19,-8,3,0.0,2022-2023
Honko Valtteri,Jymy,26,0,0,0,0,0,0,0,1,0.0,2022-2023
Kronqvist Anton,SPV,25,0,0,0,0,0,0,0,0,-,2022-2023
Koskinen Juho,TPS,23,0,0,0,4,2,8,-6,10,0.0,2022-2023
Kettunen Kaapo,KrP,23,0,0,0,24,0,0,0,0,-,2022-2023
Laukkanen Jarno,KrP,20,0,0,0,0,10,7,3,7,0.0,2022-2023
woivalin juuso,Classic,19,0,0,0,0,2,5,-3,1,0.0,2022-2023
Tiainen Tuomas,Indians,19,0,0,0,0,4,3,1,4,0.0,2022-2023
Kuisma Niklas,Happee,19,0,0,0,0,1,1,0,0,-,2022-2023
Kerola Jacob,ErVi,19,0,0,0,0,14,24,-10,15,0.0,2022-2023
Soininen Mirko,Jymy,15,0,0,0,2,1,7,-6,6,0.0,2022-2023
Salonen Arttu,FBC,14,0,0,0,4,6,21,-15,8,0.0,2022-2023
Ainoa Luka,KrP,13,0,0,0,0,4,6,-2,3,0.0,2022-2023
Kortesluoma Jesse,Jymy,12,0,0,0,0,0,5,-5,4,0.0,2022-2023
Junkkari Jonatan,Indians,12,0,0,0,0,3,2,1,2,0.0,2022-2023
Tuomala Miro,KrP,11,0,0,0,0,0,0,0,0,-,2022-2023
Toropainen Santeri,Indians,10,0,0,0,0,1,3,-2,4,0.0,2022-2023
Pokela Matias,Jymy,10,0,0,0,0,0,0,0,0,-,2022-2023
Hallbäck Marek,FBC,10,0,0,0,0,0,0,0,0,-,2022-2023
Liukkonen Teppo,SPV,9,0,0,0,0,0,0,0,1,0.0,2022-2023
Ilmivalta Topias,Oilers,9,0,0,0,0,1,4,-3,0,-,2022-2023
Kallio Emil,Oilers,8,0,0,0,0,1,0,1,5,0.0,2022-2023
Huolman Luukas,ErVi,8,0,0,0,0,3,8,-5,5,0.0,2022-2023
Ahola Vili,LASB,7,0,0,0,2,3,11,-8,5,0.0,2022-2023
Helin Eemil,Oilers,6,0,0,0,0,0,3,-3,2,0.0,2022-2023
Vormisto Petteri,LASB,5,0,0,0,0,0,0,0,0,-,2022-2023
Nurmela Roni,Indians,5,0,0,0,0,0,0,0,0,-,2022-2023
Kulmala Kasper,TPS,5,0,0,0,0,0,3,-3,1,0.0,2022-2023
Siekkinen Paavo,Happee,4,0,0,0,0,1,0,1,6,0.0,2022-2023
Saarikko Sami,KrP,4,0,0,0,0,0,0,0,0,-,2022-2023
Niemi Lauri,OLS,4,0,0,0,0,2,2,0,0,-,2022-2023
Laine Valtteri,Happee,4,0,0,0,0,0,0,0,0,-,2022-2023
Korhonen Teemu,LASB,4,0,0,0,0,0,0,0,0,-,2022-2023
Seppälä Vertti,Happee,3,0,0,0,0,0,0,0,0,-,2022-2023
Ojala Touko,ErVi,3,0,0,0,0,0,0,0,0,-,2022-2023
Hellsten Rasmus,Oilers,3,0,0,0,0,0,0,0,0,-,2022-2023
Vaalto Niko,OLS,2,0,0,0,0,0,0,0,0,-,2022-2023
Tuominen Julius,Happee,2,0,0,0,0,0,1,-1,1,0.0,2022-2023
Paananen Joel,Happee,2,0,0,0,0,0,0,0,0,-,2022-2023
Lakso Teemu,SPV,2,0,0,0,0,0,0,0,0,-,2022-2023
Kanervisto Tatu,TPS,2,0,0,0,0,0,0,0,0,-,2022-2023
Hänninen Arttu,OLS,2,0,0,0,0,0,0,0,0,-,2022-2023
Haavisto Aapo,SPV,2,0,0,0,0,0,0,0,1,0.0,2022-2023
Wertheim Michael,ErVi,1,0,0,0,0,1,5,-4,2,0.0,2022-2023
Tuomaala Miko,Indians,1,0,0,0,0,0,0,0,0,-,2022-2023
Panuma Riku,OLS,1,0,0,0,0,0,0,0,0,-,2022-2023
Ollikainen Mikael,KrP,1,0,0,0,0,0,0,0,0,-,2022-2023
Nikula Eemeli,TPS,1,0,0,0,0,0,0,0,0,-,2022-2023
Mankinen Arttu,TPS,1,0,0,0,0,0,0,0,0,-,2022-2023
Malkavs Jorens,KrP,1,0,0,0,0,0,1,-1,0,-,2022-2023
Lepojärvi Eemeli,OLS,1,0,0,0,0,0,0,0,0,-,2022-2023
Larte Joona,Oilers,1,0,0,0,0,0,0,0,0,-,2022-2023
Kivelä Ville,OLS,1,0,0,0,0,0,0,0,0,-,2022-2023
Jyrkiäinen Matti,SPV,1,0,0,0,0,0,4,-4,4,0.0,2022-2023
Huhtakallio Eemeli,Classic,1,0,0,0,0,0,0,0,0,-,2022-2023
Auvinen Otso,Classic,1,0,0,0,0,0,0,0,0,-,2022-2023
Abudu Maleeq,TPS,1,0,0,0,0,0,0,0,0,-,2022-2023
Aaltokallio Miika,Happee,1,0,0,0,0,0,0,0,0,-,2022-2023
Lastikka Ville,Classic,26,30,30,60,6,96,42,54,199,15.1,2021-2022
Kainulainen Justus,Oilers,26,37,19,56,2,105,47,58,300,12.3,2021-2022
Rantala Joona,KrP,23,29,23,52,4,103,38,65,190,15.3,2021-2022
Johansson Henri,KrP,24,22,26,48,2,96,38,58,125,17.6,2021-2022
Laakso Mikko,KrP,26,25,23,48,8,90,36,54,180,13.9,2021-2022
Ahola Juuso,Karhut,26,25,22,47,24,78,72,6,152,16.4,2021-2022
Iiskola Tuomas,Oilers,26,28,19,47,6,84,38,46,176,15.9,2021-2022
Kailiala Miko,TPS,26,25,20,45,8,88,39,49,179,14.0,2021-2022
Kainulainen Valtteri,Indians,26,26,19,45,0,90,54,36,156,16.7,2021-2022
Kainulainen Rasmus,Oilers,21,23,21,44,8,86,32,54,125,18.4,2021-2022
Hakanen Riku,Jymy,26,21,22,43,14,64,75,-11,138,15.2,2021-2022
Jerkku Tomi,Karhut,26,27,16,43,6,75,61,14,206,13.1,2021-2022
Koski Sami,SPV,26,14,28,42,12,75,40,35,90,15.6,2021-2022
Markkola Markus,Oilers,25,17,25,42,8,76,39,37,98,17.3,2021-2022
Rosendahl Tommi,ErVi,24,18,24,42,10,78,57,21,86,20.9,2021-2022
Heikkilä Oskari,Classic,26,22,20,42,34,80,40,40,88,25.0,2021-2022
Astala Aaro,Indians,23,15,26,41,0,78,42,36,164,9.1,2021-2022
Manninen Jami,Happee,26,23,17,40,6,74,53,21,245,9.4,2021-2022
Kinnunen Teuvo,Steelers,21,25,15,40,24,55,61,-6,186,13.4,2021-2022
Viitakoski Valtteri,KrP,26,24,13,37,8,62,37,25,129,18.6,2021-2022
Sieppi Joni-Arttu,OLS,26,24,13,37,4,60,53,7,226,10.6,2021-2022
Salokangas Tiitus,LASB,25,18,18,36,2,55,50,5,115,15.7,2021-2022
Hautaniemi Mikko,TPS,22,21,15,36,4,62,31,31,148,14.2,2021-2022
Mäkinen Miska,KrP,24,13,21,34,4,96,45,51,40,32.5,2021-2022
Lindfors Santeri,Oilers,26,18,16,34,42,69,46,23,99,18.2,2021-2022
Johansson Sami,Classic,18,23,11,34,2,56,29,27,159,14.5,2021-2022
Haveri Elmeri,Jymy,26,27,7,34,4,51,63,-12,135,20.0,2021-2022
Jonaeson Nico,KrP,25,17,15,32,4,85,39,46,163,10.4,2021-2022
Moilanen Mika,ErVi,24,23,8,31,8,63,60,3,115,20.0,2021-2022
Koskinen Albert,Classic,25,26,5,31,6,61,21,40,148,17.6,2021-2022
Molkka Valtteri,Steelers,26,18,12,30,12,55,79,-24,124,14.5,2021-2022
Keskinen Juuso,SPV,22,19,11,30,8,52,35,17,129,14.7,2021-2022
Ahokas Aleksi,TPS,25,13,16,29,4,72,27,45,88,14.8,2021-2022
Kovanen Joonatan,KrP,26,15,14,29,0,68,33,35,148,10.1,2021-2022
Lund Joakim,ErVi,23,18,11,29,8,55,43,12,157,11.5,2021-2022
Hirvisuo Ville,TPS,25,11,17,28,6,71,37,34,75,14.7,2021-2022
Lehkosuo Otto,Indians,26,13,15,28,6,90,50,40,121,10.7,2021-2022
Lahti Joel,Happee,26,14,14,28,4,73,48,25,62,22.6,2021-2022
Salminen Toni,TPS,25,15,13,28,2,71,31,40,91,16.5,2021-2022
Starck Kevin,Tiikerit,25,14,13,27,28,50,67,-17,137,10.2,2021-2022
Pelto-Arvo Jukka-Pekka,SPV,26,21,6,27,6,63,49,14,109,19.3,2021-2022
Koljonen Perttu,LASB,26,13,13,26,0,45,48,-3,158,8.2,2021-2022
Ojala Tuomas,TPS,26,14,12,26,4,57,38,19,89,15.7,2021-2022
Huhtala Tuomas,Karhut,25,16,10,26,24,62,63,-1,75,21.3,2021-2022
Tykkyläinen Konsta,Classic,26,18,8,26,0,61,27,34,105,17.1,2021-2022
Sariola Eetu,Jymy,26,11,14,25,12,53,61,-8,138,8.0,2021-2022
Salin Eemeli,Classic,14,13,12,25,10,44,16,28,87,14.9,2021-2022
Niemelä Jere,TPS,24,14,11,25,22,73,27,46,110,12.7,2021-2022
Salmi Markus,Happee,22,21,4,25,0,48,27,21,163,12.9,2021-2022
Haukkala Konsta,SPV,24,15,9,24,8,43,43,0,88,17.0,2021-2022
Junkkarinen Jonne,Happee,26,4,19,23,6,68,46,22,37,10.8,2021-2022
Piha Jussi,Classic,24,4,19,23,2,50,22,28,26,15.4,2021-2022
Laiti Niko,Happee,23,11,12,23,4,49,29,20,108,10.2,2021-2022
Sorri Juho,OLS,23,14,9,23,0,44,45,-1,130,10.8,2021-2022
Hankkio Jari,SPV,21,14,9,23,8,45,28,17,156,9.0,2021-2022
Vanhatalo Eero,Karhut,22,15,8,23,4,37,60,-23,106,14.2,2021-2022
Remes Christian,Tiikerit,21,15,8,23,4,40,62,-22,170,8.8,2021-2022
Sikkinen Eetu,Classic,25,10,12,22,16,67,43,24,52,19.2,2021-2022
Perälä Niko-Arttu,Jymy,25,19,3,22,0,49,54,-5,75,25.3,2021-2022
Sipronen Markus,Steelers,14,8,13,21,16,38,41,-3,93,8.6,2021-2022
Granlund Samuli,Tiikerit,25,9,12,21,6,42,59,-17,108,8.3,2021-2022
Hakala Tommi,Jymy,26,11,10,21,0,52,62,-10,129,8.5,2021-2022
Laasonen Roni,Happee,24,16,5,21,14,58,39,19,135,11.9,2021-2022
Wikstedt Olli,OLS,20,7,13,20,8,46,40,6,51,13.7,2021-2022
Hoikkanen Janne,TPS,22,14,6,20,26,37,24,13,65,21.5,2021-2022
Einiö Niko,LASB,26,15,5,20,8,35,36,-1,138,10.9,2021-2022
Harjula Tuomas,Indians,26,7,12,19,0,68,44,24,50,14.0,2021-2022
Laitila Alpo,Classic,26,8,11,19,2,46,23,23,68,11.8,2021-2022
Auranen Leevi,Indians,24,8,11,19,6,36,36,0,76,10.5,2021-2022
Siekkinen Kaapo,Happee,24,9,10,19,4,64,39,25,94,9.6,2021-2022
Kinnunen Olli,OLS,22,9,10,19,6,52,47,5,122,7.4,2021-2022
Minkkinen Matti,Happee,24,14,5,19,2,37,29,8,112,12.5,2021-2022
Havula Tatu,LASB,26,5,13,18,0,47,54,-7,54,9.3,2021-2022
Myllyharju Juho,Karhut,26,9,9,18,4,34,51,-17,82,11.0,2021-2022
Salo Teppo,Indians,21,9,9,18,2,26,31,-5,50,18.0,2021-2022
Iskanius Miika,Tiikerit,23,10,8,18,38,44,59,-15,48,20.8,2021-2022
Huppunen Jesse-Samuli,Indians,21,11,7,18,4,40,38,2,78,14.1,2021-2022
Niskanen Sami,Indians,26,13,5,18,8,39,28,11,72,18.1,2021-2022
Kukkola Jani,ErVi,16,4,13,17,8,34,36,-2,69,5.8,2021-2022
Viitanen Joonas,Steelers,18,6,11,17,16,45,54,-9,72,8.3,2021-2022
Paulaharju Simo,KrP,26,8,9,17,2,35,25,10,63,12.7,2021-2022
Talvitie Ilari,Oilers,24,9,8,17,6,63,37,26,56,16.1,2021-2022
Leikkanen Mikko,Classic,26,10,7,17,2,86,48,38,82,12.2,2021-2022
Ijäs Eetu,OLS,22,10,7,17,6,34,38,-4,57,17.5,2021-2022
Auvinen Jasper,Indians,18,11,6,17,4,40,23,17,68,16.2,2021-2022
Lindholm Joonatan,ErVi,24,12,5,17,12,46,54,-8,140,8.6,2021-2022
Lindfors Jesperi,Oilers,25,4,12,16,6,65,34,31,47,8.5,2021-2022
Saarela Miko,Jymy,24,5,11,16,8,34,47,-13,42,11.9,2021-2022
Ukkonen Eemil,Happee,24,7,9,16,2,42,38,4,71,9.9,2021-2022
Salo Tuukka,Classic,23,8,8,16,0,49,26,23,42,19.0,2021-2022
Megyaszai Daniel,LASB,25,9,7,16,8,38,54,-16,58,15.5,2021-2022
Salo Nico,Classic,19,9,7,16,6,58,28,30,58,15.5,2021-2022
Kuusela Ville-Pertti,SPV,26,12,4,16,12,55,56,-1,80,15.0,2021-2022
Suominen Marius,TPS,23,12,4,16,2,27,12,15,46,26.1,2021-2022
Urmas Henri,SPV,25,1,14,15,6,59,51,8,49,2.0,2021-2022
Suomela Antti,Oilers,24,3,12,15,2,89,47,42,51,5.9,2021-2022
Lamminen Janne,Classic,22,3,12,15,4,61,26,35,29,10.3,2021-2022
Vänttilä Kimi,OLS,26,5,10,15,2,35,48,-13,52,9.6,2021-2022
Salo Juuso,Tiikerit,26,6,9,15,12,39,82,-43,57,10.5,2021-2022
Tiainen Tuomas,Tiikerit,25,7,8,15,2,31,67,-36,55,12.7,2021-2022
Suhanto Eppu,Happee,25,7,8,15,6,33,21,12,56,12.5,2021-2022
Vesterinen Waltteri,TPS,25,8,7,15,6,47,31,16,78,10.3,2021-2022
Tammiranta Aaro,SPV,21,9,6,15,2,32,23,9,55,16.4,2021-2022
Alatorvinen Joona,OLS,21,9,6,15,8,26,42,-16,73,12.3,2021-2022
Karjanlahti Eemeli,Jymy,26,11,4,15,10,44,58,-14,70,15.7,2021-2022
Arola Jesse,LASB,24,12,3,15,8,33,44,-11,73,16.4,2021-2022
Niemelä Petri,OLS,25,14,1,15,6,23,36,-13,58,24.1,2021-2022
Kapanen Lauri,ErVi,14,6,8,14,2,44,32,12,47,12.8,2021-2022
Veikkola Matias,Oilers,24,7,7,14,2,76,45,31,49,14.3,2021-2022
Stenfors Lauri,TPS,24,8,6,14,0,49,38,11,36,22.2,2021-2022
Heikkilä Jeri,SPV,22,9,5,14,2,40,23,17,70,12.9,2021-2022
Junnila Samuli,Indians,23,10,4,14,8,31,18,13,83,12.0,2021-2022
Autio Janne,SPV,26,2,11,13,4,36,42,-6,33,6.1,2021-2022
Juuranto Matias,Oilers,26,4,9,13,6,35,28,7,81,4.9,2021-2022
Akola Eemeli,Classic,26,4,9,13,8,61,34,27,33,12.1,2021-2022
Järvinen Perttu,ErVi,23,5,8,13,6,28,37,-9,52,9.6,2021-2022
Laine Olli-Akseli,TPS,22,5,8,13,4,48,22,26,58,8.6,2021-2022
Nurminen Janne,TPS,22,6,7,13,8,35,25,10,23,26.1,2021-2022
Krumins Morics,KrP,21,6,7,13,6,67,33,34,43,14.0,2021-2022
Niinikoski Juho,ErVi,26,7,6,13,2,21,19,2,60,11.7,2021-2022
Heikkinen Juuso,Happee,17,8,5,13,4,39,26,13,44,18.2,2021-2022
Kotilainen Peter,Happee,7,3,9,12,26,18,8,10,58,5.2,2021-2022
Mustonen Tuomas,SPV,24,4,8,12,12,39,36,3,28,14.3,2021-2022
Lundgren Julius,Karhut,22,4,8,12,4,21,38,-17,40,10.0,2021-2022
Harjula Eero,Indians,26,5,7,12,0,17,18,-1,37,13.5,2021-2022
Juselius Marko,ErVi,24,5,7,12,30,67,52,15,140,3.6,2021-2022
Vaajala Matias,Classic,25,6,6,12,0,29,10,19,42,14.3,2021-2022
Myllymäki Henri,SPV,22,6,6,12,4,26,26,0,39,15.4,2021-2022
Stenberg Henri,Steelers,20,8,4,12,0,42,62,-20,59,13.6,2021-2022
Hautamäki Jaakko,TPS,26,2,9,11,4,36,19,17,14,14.3,2021-2022
Honkaniemi Miikka,Jymy,26,3,8,11,0,33,44,-11,37,8.1,2021-2022
Nivala Tino,LASB,26,7,4,11,2,41,50,-9,88,8.0,2021-2022
Tuominen Julius,Karhut,22,7,4,11,4,25,43,-18,25,28.0,2021-2022
Ruonakangas Riku,OLS,21,7,4,11,6,25,12,13,42,16.7,2021-2022
Henttonen Joni,KrP,20,7,4,11,4,52,31,21,38,18.4,2021-2022
Kauppinen Pyry,Steelers,15,7,4,11,2,29,31,-2,63,11.1,2021-2022
Horttanainen Eemeli,Tiikerit,24,8,3,11,6,22,55,-33,50,16.0,2021-2022
Alkki Lauri,KrP,25,1,9,10,6,40,31,9,15,6.7,2021-2022
woivalin juuso,Steelers,26,2,8,10,2,31,74,-43,33,6.1,2021-2022
Ailio Tuure,Oilers,18,2,8,10,0,25,17,8,18,11.1,2021-2022
Roth Anton,Jymy,19,3,7,10,10,28,47,-19,60,5.0,2021-2022
Koskinen Ossi,Indians,24,4,6,10,16,39,37,2,34,11.8,2021-2022
Palvaila Lauri,LASB,25,5,5,10,8,35,57,-22,35,14.3,2021-2022
Sillanpää Oliver,ErVi,22,6,4,10,4,20,31,-11,71,8.5,2021-2022
Puolakka Joni,LASB,20,6,4,10,8,27,36,-9,26,23.1,2021-2022
Silvonen Jesper,Oilers,17,6,4,10,2,17,4,13,25,24.0,2021-2022
Nykänen Eetu,Indians,26,7,3,10,6,46,40,6,67,10.4,2021-2022
Pesu Eino,Oilers,20,7,3,10,8,17,12,5,43,16.3,2021-2022
Hietaranta Ville,Classic,22,8,2,10,4,19,6,13,39,20.5,2021-2022
Wiander Tommi,OLS,26,1,8,9,10,48,62,-14,37,2.7,2021-2022
Kivilehto Juha,Classic,23,1,8,9,8,61,38,23,20,5.0,2021-2022
Kuisma Niklas,Tiikerit,24,4,5,9,6,34,66,-32,87,4.6,2021-2022
Kotovaara Lassi,Happee,19,4,5,9,8,21,22,-1,14,28.6,2021-2022
Rauhala Jani,Oilers,24,5,4,9,2,29,22,7,70,7.1,2021-2022
Hirsikorpi Mika,OLS,24,5,4,9,8,20,27,-7,61,8.2,2021-2022
Lamminen Kristian,Oilers,17,6,3,9,0,22,14,8,81,7.4,2021-2022
Iiskola Heikki,Oilers,11,6,3,9,24,30,14,16,41,14.6,2021-2022
Hautaoja Markus,Steelers,26,7,2,9,6,20,56,-36,55,12.7,2021-2022
Lehtonen Konsta,LASB,19,7,2,9,4,13,33,-20,42,16.7,2021-2022
Alin Juuso,TPS,25,1,7,8,0,33,35,-2,21,4.8,2021-2022
Lintula Matias,SPV,26,3,5,8,8,41,47,-6,45,6.7,2021-2022
Ruohonen Tatu,Karhut,25,4,4,8,12,35,75,-40,29,13.8,2021-2022
Aarela Ilmari,Happee,25,4,4,8,0,32,30,2,42,9.5,2021-2022
Annila Eetu,Karhut,24,4,4,8,2,13,42,-29,45,8.9,2021-2022
Välitalo Anssi,OLS,23,4,4,8,2,22,32,-10,46,8.7,2021-2022
Puska Perttu,Indians,21,4,4,8,4,17,24,-7,39,10.3,2021-2022
Salonen Ville,Karhut,17,4,4,8,4,26,47,-21,23,17.4,2021-2022
Majalahti Mika,ErVi,23,5,3,8,6,15,48,-33,54,9.3,2021-2022
Kurkikangas Atte,Steelers,22,6,2,8,2,23,55,-32,42,14.3,2021-2022
Tenhonen Daniel,ErVi,15,6,2,8,0,17,18,-1,37,16.2,2021-2022
Karjanlahti Eero,SPV,21,8,0,8,2,21,23,-2,39,20.5,2021-2022
Laine Valtteri,Tiikerit,15,1,6,7,26,15,39,-24,38,2.6,2021-2022
Blomqvist Otto,ErVi,22,2,5,7,4,12,14,-2,14,14.3,2021-2022
Halminen Joni,Karhut,16,2,5,7,2,36,35,1,21,9.5,2021-2022
Aro Konsta,Karhut,15,2,5,7,4,15,19,-4,14,14.3,2021-2022
Kukko Arttu,Jymy,26,3,4,7,4,32,65,-33,25,12.0,2021-2022
Storgårds Erik,Happee,23,3,4,7,2,52,41,11,40,7.5,2021-2022
Viitala Lauri,Happee,21,3,4,7,0,18,14,4,29,10.3,2021-2022
Ragovskis Janis,LASB,20,3,4,7,0,23,35,-12,26,11.5,2021-2022
Laaksonen Nikolas,TPS,19,3,4,7,2,25,19,6,35,8.6,2021-2022
Korhonen Matti,LASB,17,3,4,7,4,25,15,10,39,7.7,2021-2022
Mattila Jere,KrP,16,4,3,7,4,36,22,14,32,12.5,2021-2022
Tikka Juha,Karhut,15,4,3,7,2,8,21,-13,22,18.2,2021-2022
Eklund Emil,KrP,25,5,2,7,8,24,23,1,45,11.1,2021-2022
Rantaniemi Aapo,OLS,21,5,2,7,2,20,32,-12,41,12.2,2021-2022
Mäkinen Jarno,Steelers,19,5,2,7,0,36,53,-17,45,11.1,2021-2022
Aho Tuomas,ErVi,14,6,1,7,12,27,31,-4,38,15.8,2021-2022
Rautio Petro,Jymy,18,0,6,6,0,22,24,-2,10,0.0,2021-2022
Varjokumpu Juuso,LASB,26,1,5,6,4,49,60,-11,38,2.6,2021-2022
Kainulainen Leevi,Steelers,24,1,5,6,6,12,48,-36,25,4.0,2021-2022
rautava vertti,Karhut,21,1,5,6,6,24,53,-29,16,6.3,2021-2022
Hakonen Petri,SPV,18,1,5,6,8,20,17,3,30,3.3,2021-2022
Uusi-Laitila Santeri,SPV,17,1,5,6,6,22,24,-2,33,3.0,2021-2022
Tiira Lauri,OLS,26,2,4,6,0,22,44,-22,23,8.7,2021-2022
Järnfors Valtteri,Tiikerit,25,2,4,6,6,28,75,-47,38,5.3,2021-2022
Kauppila Oskari,Jymy,23,2,4,6,4,8,11,-3,18,11.1,2021-2022
Mäenpää Matias,Jymy,26,3,3,6,8,20,31,-11,41,7.3,2021-2022
Lehto Julius,LASB,24,3,3,6,0,14,29,-15,28,10.7,2021-2022
Aalto Sami,Tiikerit,24,3,3,6,4,13,54,-41,31,9.7,2021-2022
Puntanen Eetu,Jymy,19,3,3,6,4,29,33,-4,43,7.0,2021-2022
Kanervisto Tatu,TPS,13,3,3,6,2,26,8,18,32,9.4,2021-2022
Järvikangas Viljami,Jymy,26,0,5,5,32,37,66,-29,13,0.0,2021-2022
Budde Karri,Tiikerit,26,1,4,5,4,29,71,-42,85,1.2,2021-2022
Santanen Kalle,Karhut,23,1,4,5,6,46,60,-14,27,3.7,2021-2022
Kilpi Otto,Classic,22,1,4,5,4,30,14,16,38,2.6,2021-2022
Lehto Kosti,OLS,18,1,4,5,6,21,28,-7,13,7.7,2021-2022
Tenhonen Benjamin,ErVi,16,1,4,5,0,10,16,-6,17,5.9,2021-2022
Kauppinen Eero,Steelers,13,1,4,5,6,11,26,-15,17,5.9,2021-2022
Virrankari Olli-Matti,OLS,26,2,3,5,0,37,44,-7,15,13.3,2021-2022
Oksanen Jere,Indians,18,2,3,5,0,12,8,4,28,7.1,2021-2022
Jalonen Ossi,ErVi,18,2,3,5,4,38,38,0,35,5.7,2021-2022
Toropainen Santeri,Indians,16,2,3,5,4,20,14,6,33,6.1,2021-2022
Taskinen Olli,Tiikerit,25,3,2,5,4,11,51,-40,24,12.5,2021-2022
Repo Juho,SPV,22,3,2,5,0,20,21,-1,41,7.3,2021-2022
Kallio Emil,Oilers,9,3,2,5,0,10,6,4,14,21.4,2021-2022
Kokljuschkin Mattias,Tiikerit,26,4,1,5,12,16,72,-56,79,5.1,2021-2022
Koistinen Jere,KrP,20,4,1,5,0,9,11,-2,39,10.3,2021-2022
Ylikojola Mikko,Tiikerit,19,4,1,5,4,23,54,-31,29,13.8,2021-2022
Seppälä Vertti,Happee,18,4,1,5,2,11,5,6,8,50.0,2021-2022
Tenho Oskari,KrP,15,4,1,5,2,8,12,-4,19,21.1,2021-2022
Juuti Jasper,Oilers,9,4,1,5,0,8,4,4,9,44.4,2021-2022
Parviainen Valtteri,OLS,7,4,1,5,0,9,9,0,28,14.3,2021-2022
Tamminen Aapo,Karhut,14,0,4,4,0,30,35,-5,10,0.0,2021-2022
Savinainen Kaapo,Happee,25,1,3,4,4,12,16,-4,7,14.3,2021-2022
Pentikäinen Miikka,LASB,25,1,3,4,10,25,55,-30,19,5.3,2021-2022
Latvala Miika,SPV,23,1,3,4,4,25,37,-12,24,4.2,2021-2022
Hiltunen Veeti,Steelers,25,2,2,4,6,13,39,-26,40,5.0,2021-2022
Ranki Ville,Steelers,24,2,2,4,6,19,46,-27,14,14.3,2021-2022
Kolari Aki,Tiikerit,23,2,2,4,0,20,36,-16,16,12.5,2021-2022
Estovirta Tomas,KrP,23,2,2,4,2,30,29,1,43,4.7,2021-2022
Harle Teemu,OLS,21,2,2,4,2,16,25,-9,32,6.3,2021-2022
Santanen Mikko,KrP,18,2,2,4,6,22,14,8,17,11.8,2021-2022
Eklund Alex,ErVi,18,2,2,4,2,4,3,1,10,20.0,2021-2022
Savolainen Sami,KrP,21,3,1,4,0,12,9,3,31,9.7,2021-2022
Lokasaari Aapo,SPV,15,3,1,4,0,19,20,-1,34,8.8,2021-2022
Alatalo Pieti,Steelers,14,3,1,4,4,28,29,-1,28,10.7,2021-2022
Määttä Salomo,Jymy,12,3,1,4,0,13,26,-13,14,21.4,2021-2022
Holappa Niko-Petteri,OLS,23,0,3,3,0,19,30,-11,12,0.0,2021-2022
Jaanus Janne,LASB,19,0,3,3,2,17,33,-16,20,0.0,2021-2022
Hiltunen Aleksi,Steelers,26,1,2,3,12,20,59,-39,22,4.5,2021-2022
Simonen Topias,KrP,17,1,2,3,0,10,13,-3,12,8.3,2021-2022
Karvonen Valte,OLS,8,1,2,3,0,9,10,-1,10,10.0,2021-2022
Ainoa Luka,ErVi,25,2,1,3,2,25,35,-10,31,6.5,2021-2022
Puisto Tuomas,Karhut,22,2,1,3,8,19,35,-16,21,9.5,2021-2022
Auroila Jukkapekka,LASB,20,2,1,3,4,9,20,-11,19,10.5,2021-2022
Salonen Janne,Indians,25,3,0,3,4,18,22,-4,15,20.0,2021-2022
Pekari Elias,Oilers,24,3,0,3,4,14,15,-1,44,6.8,2021-2022
Kotka Timi,LASB,15,3,0,3,2,6,13,-7,17,17.6,2021-2022
Sipilä Nemo,ErVi,26,0,2,2,0,26,36,-10,0,-,2021-2022
Pohjonen Santtu,LASB,25,0,2,2,2,3,5,-2,0,-,2021-2022
Jääskeläinen Pietari,Steelers,23,0,2,2,0,0,0,0,0,-,2021-2022
Lindstedt Tino,KrP,16,0,2,2,2,10,10,0,4,0.0,2021-2022
Larte Joona,Oilers,13,0,2,2,0,8,8,0,2,0.0,2021-2022
Alaluusua Samuli,Indians,12,0,2,2,2,16,14,2,9,0.0,2021-2022
Metsälä Teemu,ErVi,10,0,2,2,0,11,20,-9,31,0.0,2021-2022
Pietinen Matias,LASB,9,0,2,2,12,3,7,-4,4,0.0,2021-2022
Savolainen Atte,OLS,3,0,2,2,0,5,3,2,1,0.0,2021-2022
Hyvärinen Luukas,OLS,3,0,2,2,0,5,2,3,7,0.0,2021-2022
Yrjänen Roope,Steelers,26,1,1,2,4,6,39,-33,28,3.6,2021-2022
Levola Daniel,Karhut,25,1,1,2,4,27,36,-9,16,6.3,2021-2022
Turula Veli-Pekka,ErVi,23,1,1,2,0,5,13,-8,20,5.0,2021-2022
Pollari Miika,Jymy,23,1,1,2,8,24,53,-29,10,10.0,2021-2022
Salokangas Julius,LASB,18,1,1,2,2,10,15,-5,16,6.3,2021-2022
Jokela Olli,Oilers,17,1,1,2,2,13,6,7,12,8.3,2021-2022
Loippo Leevi,Tiikerit,16,1,1,2,6,7,29,-22,22,4.5,2021-2022
Wikström Roope,KrP,10,1,1,2,0,2,6,-4,6,16.7,2021-2022
Pylväläinen Arttu,Happee,10,1,1,2,24,6,2,4,2,50.0,2021-2022
Helin Niilo,Classic,10,1,1,2,0,3,1,2,6,16.7,2021-2022
Ahola Timi,Steelers,24,2,0,2,4,10,40,-30,15,13.3,2021-2022
Lehtimäki Roni,Tiikerit,10,2,0,2,2,2,11,-9,11,18.2,2021-2022
Karjula Joona,OLS,3,2,0,2,0,3,1,2,5,40.0,2021-2022
Lallukka Ossi,Jymy,26,0,1,1,0,0,0,0,0,-,2021-2022
Hasu Rasmus,SPV,26,0,1,1,0,0,0,0,0,-,2021-2022
Laakso Markus,Happee,25,0,1,1,0,8,4,4,0,-,2021-2022
Sjöholm Mikko,Tiikerit,24,0,1,1,0,0,0,0,0,-,2021-2022
Kivilompolo Vinski,OLS,24,0,1,1,0,0,0,0,0,-,2021-2022
Toriseva Lassi,Classic,23,0,1,1,0,8,2,6,1,0.0,2021-2022
Tuomala Miro,KrP,19,0,1,1,0,6,5,1,0,-,2021-2022
Saari Arttu,Jymy,19,0,1,1,10,19,35,-16,20,0.0,2021-2022
Nyman Alexander,Oilers,14,0,1,1,2,15,15,0,4,0.0,2021-2022
Järvi Paavo,Karhut,12,0,1,1,0,6,17,-11,2,0.0,2021-2022
Tommila Aatu,Karhut,11,0,1,1,2,6,20,-14,15,0.0,2021-2022
Hytönen Tuukka,Steelers,10,0,1,1,2,2,11,-9,12,0.0,2021-2022
Virtanen Jasper,Jymy,7,0,1,1,2,1,5,-4,4,0.0,2021-2022
Väänänen Roni,OLS,5,0,1,1,0,1,3,-2,2,0.0,2021-2022
Aaltonen Julius,Steelers,4,0,1,1,2,6,13,-7,6,0.0,2021-2022
Sikiö Mio,Happee,2,0,1,1,0,2,2,0,0,-,2021-2022
Koskinen Joonas,TPS,21,1,0,1,0,5,11,-6,24,4.2,2021-2022
Lillas Didrik,Jymy,20,1,0,1,4,6,17,-11,19,5.3,2021-2022
Kangas Topias,Happee,20,1,0,1,0,8,5,3,10,10.0,2021-2022
Kareinen Miikka,Indians,19,1,0,1,0,7,10,-3,12,8.3,2021-2022
Junkkari Jonatan,Indians,17,1,0,1,0,9,10,-1,5,20.0,2021-2022
Tornberg Otso,OLS,13,1,0,1,28,11,13,-2,8,12.5,2021-2022
Haapaniemi Eero,SPV,10,1,0,1,0,2,6,-4,5,20.0,2021-2022
Summanen Miko,Oilers,8,1,0,1,2,1,1,0,3,33.3,2021-2022
Lindgren Aleksi,Tiikerit,5,1,0,1,0,1,11,-10,4,25.0,2021-2022
Koskinen Juho,TPS,4,1,0,1,0,2,3,-1,1,100.0,2021-2022
Heiska Ville,Happee,4,1,0,1,0,5,5,0,10,10.0,2021-2022
Savonen Krister,Classic,1,1,0,1,0,3,2,1,2,50.0,2021-2022
Tuononen Roni,OLS,26,0,0,0,2,3,5,-2,1,0.0,2021-2022
Kuisma Olli,TPS,26,0,0,0,0,0,1,-1,0,-,2021-2022
Kirvesniemi Mikko,Indians,26,0,0,0,0,0,0,0,0,-,2021-2022
Fälden Oskari,TPS,26,0,0,0,0,0,0,0,0,-,2021-2022
Beijar Jens,Tiikerit,26,0,0,0,0,8,6,2,1,0.0,2021-2022
Sillanpää Oskar,Classic,25,0,0,0,0,0,1,-1,0,-,2021-2022
Kaltiainen Joonas,Oilers,25,0,0,0,0,0,0,0,1,0.0,2021-2022
Mutka Roope,Jymy,24,0,0,0,0,0,0,0,0,-,2021-2022
Kronqvist Anton,SPV,24,0,0,0,0,0,0,0,0,-,2021-2022
Kanerva Jesse,KrP,24,0,0,0,2,3,3,0,5,0.0,2021-2022
Bergendahl Tomi,Karhut,24,0,0,0,0,0,0,0,0,-,2021-2022
Ripatti Antti,LASB,23,0,0,0,0,0,0,0,0,-,2021-2022
Vonk Arvid,Karhut,22,0,0,0,0,3,4,-1,0,-,2021-2022
Pulkkinen Sakari,ErVi,22,0,0,0,0,5,7,-2,1,0.0,2021-2022
Lukkari Eerik,Karhut,22,0,0,0,0,6,23,-17,33,0.0,2021-2022
Kartano Aleksi,Steelers,22,0,0,0,0,2,24,-22,9,0.0,2021-2022
Jokisalo Juuso,Indians,22,0,0,0,0,7,4,3,0,-,2021-2022
Järvinen Pasi,Steelers,21,0,0,0,0,0,0,0,0,-,2021-2022
Valajärvi Veeti,Tiikerit,20,0,0,0,0,4,47,-43,22,0.0,2021-2022
Kerola Jacob,ErVi,20,0,0,0,4,11,12,-1,8,0.0,2021-2022
Järvenpää Niko,Karhut,20,0,0,0,0,2,7,-5,3,0.0,2021-2022
Nordström Niko,Oilers,19,0,0,0,0,0,0,0,0,-,2021-2022
Merz Timon,Tiikerit,18,0,0,0,4,2,16,-14,5,0.0,2021-2022
Koskinen Valtteri,TPS,18,0,0,0,0,3,3,0,4,0.0,2021-2022
Kuutsa Eero,TPS,17,0,0,0,0,2,2,0,3,0.0,2021-2022
Hassinen Miko,Happee,15,0,0,0,0,0,1,-1,0,-,2021-2022
Korhonen Santeri,Steelers,12,0,0,0,0,1,5,-4,5,0.0,2021-2022
Aaltokallio Miika,Happee,12,0,0,0,0,0,0,0,0,-,2021-2022
Vuoristo Santtu,ErVi,11,0,0,0,0,3,7,-4,7,0.0,2021-2022
Salonen Vesa,Jymy,11,0,0,0,0,6,14,-8,0,-,2021-2022
Marjamäki Miikka,Steelers,11,0,0,0,0,0,5,-5,0,-,2021-2022
Tähkä Kasper,SPV,10,0,0,0,0,0,1,-1,3,0.0,2021-2022
Lamminmäki Martti,Jymy,10,0,0,0,2,1,11,-10,6,0.0,2021-2022
Laitinen Patrik,ErVi,10,0,0,0,0,2,15,-13,13,0.0,2021-2022
Räsänen Juho,ErVi,8,0,0,0,0,3,5,-2,8,0.0,2021-2022
Pernu Valtteri,Happee,8,0,0,0,0,0,0,0,0,-,2021-2022
Hellsten Rasmus,Oilers,8,0,0,0,0,0,0,0,0,-,2021-2022
Saarinen Miki,KrP,7,0,0,0,0,0,0,0,0,-,2021-2022
Ruuska Mikko,Steelers,7,0,0,0,0,1,6,-5,8,0.0,2021-2022
Kimpanpää Miika,Classic,7,0,0,0,0,1,1,0,1,0.0,2021-2022
Mustonen Justus,Oilers,6,0,0,0,0,0,0,0,5,0.0,2021-2022
Lakso Teemu,SPV,6,0,0,0,0,0,0,0,1,0.0,2021-2022
Lahtinen Joel,Classic,6,0,0,0,0,0,1,-1,0,-,2021-2022
Jyrkiäinen Matti,SPV,6,0,0,0,0,0,0,0,0,-,2021-2022
Jokela Jesse,Steelers,6,0,0,0,0,0,0,0,0,-,2021-2022
Suutari Ville,LASB,5,0,0,0,0,2,2,0,2,0.0,2021-2022
Suonpää Patrik,Karhut,5,0,0,0,0,0,0,0,0,-,2021-2022
Jäppinen Amos,Indians,5,0,0,0,0,0,0,0,0,-,2021-2022
Ilmivalta Topias,Oilers,5,0,0,0,0,3,4,-1,1,0.0,2021-2022
Tynkkynen Lauri,KrP,4,0,0,0,0,0,1,-1,0,-,2021-2022
Surakka Joonatan,LASB,4,0,0,0,0,1,4,-3,7,0.0,2021-2022
Sieppi Julius,Happee,4,0,0,0,0,0,2,-2,2,0.0,2021-2022
Ojala Touko,ErVi,4,0,0,0,0,0,0,0,0,-,2021-2022
Vormisto Petteri,LASB,3,0,0,0,0,0,0,0,0,-,2021-2022
Tervonen Miika,Tiikerit,3,0,0,0,0,0,1,-1,2,0.0,2021-2022
Sassi Arttu,Indians,3,0,0,0,0,0,0,0,0,-,2021-2022
Vänttinen Oliver,Classic,2,0,0,0,0,0,0,0,0,-,2021-2022
Vikstedt Antti,OLS,2,0,0,0,0,2,3,-1,7,0.0,2021-2022
Vettervik Jussi,Karhut,2,0,0,0,0,1,1,0,0,-,2021-2022
Rissanen Aarne,ErVi,2,0,0,0,0,0,0,0,0,-,2021-2022
Pulkkinen Jere,Classic,2,0,0,0,0,2,3,-1,0,-,2021-2022
Pokela Matias,Jymy,2,0,0,0,0,0,0,0,0,-,2021-2022
Peltoniemi Veeti,Classic,2,0,0,0,0,0,0,0,1,0.0,2021-2022
Pasanen Rasmus,Indians,2,0,0,0,0,0,0,0,0,-,2021-2022
Nykänen Niklas,Tiikerit,2,0,0,0,0,0,0,0,0,-,2021-2022
Miettinen Arttu,Tiikerit,2,0,0,0,2,1,1,0,1,0.0,2021-2022
Mertaniemi Väinö,OLS,2,0,0,0,0,0,0,0,0,-,2021-2022
Kataja-Rahko Sakari,ErVi,2,0,0,0,0,0,0,0,0,-,2021-2022
Karkulowski Emil,LASB,2,0,0,0,0,0,0,0,0,-,2021-2022
Jokinen Arttu,Tiikerit,2,0,0,0,0,1,3,-2,0,-,2021-2022
Hilden Leevi,Steelers,2,0,0,0,0,0,1,-1,2,0.0,2021-2022
Heinäharju Samu,Happee,2,0,0,0,2,0,1,-1,2,0.0,2021-2022
Auvinen Otso,Classic,2,0,0,0,0,0,0,0,0,-,2021-2022
kurikka Artturi,Happee,1,0,0,0,0,0,0,0,0,-,2021-2022
Viljanen Kaapo,Happee,1,0,0,0,0,0,0,0,1,0.0,2021-2022
Sulander Jere,LASB,1,0,0,0,0,0,0,0,0,-,2021-2022
Siekkinen Paavo,Happee,1,0,0,0,0,1,1,0,0,-,2021-2022
Rantaniemi Iiro,OLS,1,0,0,0,0,0,0,0,0,-,2021-2022
Rantala Leevi,ErVi,1,0,0,0,0,0,0,0,0,-,2021-2022
Panuma Riku,OLS,1,0,0,0,0,0,0,0,0,-,2021-2022
Painilainen Rasmus,Steelers,1,0,0,0,0,0,0,0,0,-,2021-2022
Paananen Joel,Happee,1,0,0,0,0,0,1,-1,1,0.0,2021-2022
Ollikainen Mikael,KrP,1,0,0,0,0,0,0,0,1,0.0,2021-2022
Manninen Eetu,Jymy,1,0,0,0,0,0,0,0,0,-,2021-2022
Kuusela Aaro,Oilers,1,0,0,0,0,0,1,-1,0,-,2021-2022
Korhonen Teemu,LASB,1,0,0,0,0,0,0,0,0,-,2021-2022
Kivelä Ville,OLS,1,0,0,0,0,2,0,2,1,0.0,2021-2022
Hämäläinen Petteri,Jymy,1,0,0,0,0,0,0,0,0,-,2021-2022
Hussi Tuure,Indians,1,0,0,0,0,0,0,0,0,-,2021-2022
Honko Valtteri,SPV,1,0,0,0,0,0,0,0,0,-,2021-2022
Haapala Otto,SPV,1,0,0,0,0,0,0,0,0,-,2021-2022
Forss Onni,Indians,1,0,0,0,0,0,0,0,0,-,2021-2022
Anson Elias,KrP,1,0,0,0,0,0,0,0,0,-,2021-2022
Johansson Sami,Classic,26,44,30,74,2,113,40,73,288,15.3,2020-2021
Rantala Joona,KrP,25,30,34,64,2,106,45,61,221,13.6,2020-2021
Johansson Henri,KrP,26,37,26,63,0,107,46,61,168,22.0,2020-2021
Salin Eemeli,Classic,26,33,27,60,0,109,50,59,216,15.3,2020-2021
Kotilainen Peter,Happee,22,30,29,59,30,81,52,29,242,12.4,2020-2021
Iiskola Tuomas,Oilers,26,25,28,53,10,80,41,39,142,17.6,2020-2021
Kailiala Miko,TPS,25,34,18,52,2,93,47,46,209,16.3,2020-2021
Kainulainen Justus,Oilers,26,35,17,52,8,95,41,54,257,13.6,2020-2021
Jonaeson Nico,KrP,26,21,26,47,8,104,53,51,148,14.2,2020-2021
Kainulainen Rasmus,Oilers,24,21,24,45,22,83,45,38,121,17.4,2020-2021
Markkola Markus,Oilers,26,20,24,44,6,87,36,51,127,15.7,2020-2021
Hautaniemi Mikko,TPS,26,22,21,43,2,75,41,34,177,12.4,2020-2021
Koski Sami,SPV,26,10,32,42,2,86,50,36,110,9.1,2020-2021
Sieppi Joni-Arttu,SPV,25,29,13,42,2,58,33,25,164,17.7,2020-2021
Lastikka Ville,Classic,26,21,20,41,0,71,61,10,223,9.4,2020-2021
Koljonen Perttu,LASB,26,28,13,41,2,62,52,10,240,11.7,2020-2021
Kainulainen Valtteri,Indians,26,33,8,41,4,88,54,34,119,27.7,2020-2021
Laakso Mikko,KrP,26,16,21,37,4,77,39,38,132,12.1,2020-2021
Salmi Markus,ErVi,25,23,12,35,10,71,53,18,190,12.1,2020-2021
Hakala Tommi,Jymy,26,18,16,34,8,52,86,-34,141,12.8,2020-2021
Salo Nico,Classic,20,12,21,33,8,87,26,61,73,16.4,2020-2021
Hirvisuo Ville,TPS,26,18,15,33,0,71,46,25,85,21.2,2020-2021
Rintala Toni,Tiikerit,25,22,11,33,6,45,61,-16,95,23.2,2020-2021
Astala Aaro,Indians,13,12,20,32,0,48,23,25,75,16.0,2020-2021
Kukkola Jani,ErVi,24,11,20,31,30,63,51,12,104,10.6,2020-2021
Nivala Tino,LASB,26,15,16,31,2,66,57,9,95,15.8,2020-2021
Manninen Jami,Happee,15,15,16,31,2,47,24,23,144,10.4,2020-2021
Pelto-Arvo Jukka-Pekka,SPV,25,16,15,31,4,74,51,23,101,15.8,2020-2021
Kotilainen Paul,Happee,24,16,15,31,0,76,50,26,123,13.0,2020-2021
Keskinen Juuso,SPV,26,18,13,31,12,48,43,5,151,11.9,2020-2021
Sorri Juho,OLS,23,18,12,30,0,52,40,12,153,11.8,2020-2021
Laasonen Roni,Happee,23,22,8,30,10,65,43,22,153,14.4,2020-2021
Sipronen Markus,Steelers,22,11,18,29,16,56,55,1,94,11.7,2020-2021
Heikkilä Oskari,Classic,24,19,10,29,16,53,33,20,122,15.6,2020-2021
Hankkio Jari,SPV,18,20,9,29,2,42,22,20,124,16.1,2020-2021
Kivioja Tuukka,OLS,26,9,19,28,8,60,47,13,160,5.6,2020-2021
Karvonen Valte,OLS,25,11,17,28,10,64,48,16,61,18.0,2020-2021
Alaluusua Samuli,Indians,25,11,17,28,8,52,34,18,104,10.6,2020-2021
Iiskola Heikki,Oilers,22,21,7,28,12,54,34,20,130,16.2,2020-2021
Piha Jussi,Classic,26,4,23,27,4,68,48,20,51,7.8,2020-2021
Ahokas Aleksi,Welhot,25,11,16,27,2,37,84,-47,115,9.6,2020-2021
Surakka Joonatan,LASB,26,15,12,27,4,65,56,9,143,10.5,2020-2021
Lund Joakim,Tiikerit,21,15,12,27,12,39,49,-10,150,10.0,2020-2021
Vesterinen Waltteri,TPS,26,16,11,27,10,72,37,35,101,15.8,2020-2021
Lindholm Joonatan,ErVi,26,12,14,26,6,66,52,14,121,9.9,2020-2021
Kovanen Joonatan,KrP,25,14,12,26,6,76,38,38,120,11.7,2020-2021
Heikkinen Juuso,Happee,26,20,6,26,12,56,46,10,95,21.1,2020-2021
Tuononen Riku,Welhot,26,12,13,25,10,36,91,-55,175,6.9,2020-2021
Bolliger Silvan,Happee,21,15,10,25,0,53,41,12,76,19.7,2020-2021
Niskanen Sami,Indians,25,12,12,24,6,53,44,9,61,19.7,2020-2021
Forsman Juuso,TPS,26,17,7,24,10,53,29,24,112,15.2,2020-2021
Laiti Niko,Indians,25,18,6,24,4,57,42,15,117,15.4,2020-2021
Lindfors Jesperi,Oilers,26,8,15,23,4,64,41,23,46,17.4,2020-2021
Megyaszai Daniel,Steelers,24,10,13,23,8,45,67,-22,109,9.2,2020-2021
Paulaharju Simo,KrP,26,13,10,23,6,37,35,2,92,14.1,2020-2021
Salo Teppo,Indians,25,13,10,23,0,36,44,-8,80,16.3,2020-2021
Sikkinen Eetu,Classic,26,10,12,22,2,45,31,14,62,16.1,2020-2021
Haukkala Konsta,SPV,26,10,12,22,26,56,44,12,94,10.6,2020-2021
Liponen Vili,KrP,26,12,10,22,4,53,40,13,61,19.7,2020-2021
Lindfors Santeri,Oilers,26,13,9,22,4,63,38,25,53,24.5,2020-2021
Hoikkanen Janne,TPS,25,13,9,22,4,39,30,9,68,19.1,2020-2021
Matilainen Nico,Steelers,25,15,7,22,6,48,56,-8,124,12.1,2020-2021
Stenfors Lauri,TPS,26,8,13,21,14,68,39,29,50,16.0,2020-2021
Mäkinen Jarno,Steelers,24,8,13,21,14,57,65,-8,52,15.4,2020-2021
Salminen Toni,TPS,22,10,11,21,4,64,28,36,51,19.6,2020-2021
Lamminen Janne,Classic,23,11,10,21,6,72,43,29,61,18.0,2020-2021
Ukkonen Eemil,Happee,25,6,14,20,6,56,46,10,83,7.2,2020-2021
Mäkinen Miska,LASB,18,8,12,20,0,46,35,11,62,12.9,2020-2021
Iskanius Miika,Tiikerit,26,9,11,20,16,47,50,-3,40,22.5,2020-2021
Palomäki Hannu,Jymy,22,10,10,20,2,41,49,-8,75,13.3,2020-2021
Siekkinen Kaapo,Happee,21,14,6,20,12,55,36,19,75,18.7,2020-2021
Juselius Marko,ErVi,25,8,11,19,6,43,36,7,92,8.7,2020-2021
Kinnunen Teuvo,Steelers,11,12,7,19,6,28,28,0,94,12.8,2020-2021
Veikkola Matias,Oilers,23,3,15,18,4,82,39,43,38,7.9,2020-2021
Ailio Tuure,LASB,26,6,12,18,0,60,57,3,95,6.3,2020-2021
Kukko Joona,Jymy,25,8,10,18,10,47,70,-23,59,13.6,2020-2021
Rosendahl Tommi,ErVi,13,8,10,18,6,44,20,24,49,16.3,2020-2021
Simonen Topias,Welhot,26,10,8,18,10,31,87,-56,92,10.9,2020-2021
Remes Christian,Tiikerit,24,11,7,18,2,33,46,-13,100,11.0,2020-2021
Alatorvinen Joona,OLS,20,14,4,18,6,32,19,13,76,18.4,2020-2021
Lindroos Yannick,Tiikerit,26,3,14,17,10,31,52,-21,74,4.1,2020-2021
Laurila Niklas,Tiikerit,26,7,10,17,6,48,53,-5,63,11.1,2020-2021
Nykänen Eetu,Indians,16,11,6,17,8,36,30,6,61,18.0,2020-2021
Kuusela Ville-Pertti,SPV,26,12,5,17,10,67,61,6,76,15.8,2020-2021
Moilanen Mika,ErVi,25,12,5,17,6,47,56,-9,102,11.8,2020-2021
Helin Aaro,Classic,26,14,3,17,4,35,22,13,94,14.9,2020-2021
Wiander Tommi,OLS,26,4,12,16,14,58,62,-4,43,9.3,2020-2021
Aho Tuomas,ErVi,25,4,12,16,2,39,54,-15,46,8.7,2020-2021
Jalo Eero,TPS,11,4,12,16,4,39,11,28,48,8.3,2020-2021
Urmas Henri,SPV,24,5,11,16,0,56,45,11,50,10.0,2020-2021
Pfitzner Casper,Oilers,23,5,11,16,2,40,22,18,30,16.7,2020-2021
Kotovaara Lassi,Happee,18,5,11,16,8,44,27,17,54,9.3,2020-2021
Leikkanen Mikko,Classic,20,8,8,16,6,82,40,42,53,15.1,2020-2021
Hakonen Petri,SPV,21,9,7,16,6,46,30,16,86,10.5,2020-2021
Tiira Matias,OLS,15,9,7,16,0,27,32,-5,42,21.4,2020-2021
Mattila Jere,KrP,26,10,6,16,2,56,44,12,43,23.3,2020-2021
Autio Janne,SPV,21,10,6,16,4,42,36,6,43,23.3,2020-2021
Näveri Vili,LASB,26,11,5,16,8,42,49,-7,67,16.4,2020-2021
Salo Juuso,Tiikerit,26,12,4,16,4,36,56,-20,64,18.8,2020-2021
Einiö Niko,Steelers,12,12,4,16,2,30,35,-5,75,16.0,2020-2021
Junkkarinen Jonne,Happee,17,3,12,15,4,56,32,24,38,7.9,2020-2021
Lahti Joel,Happee,26,6,9,15,4,77,55,22,43,14.0,2020-2021
Sorvali Eetu,ErVi,26,8,7,15,0,34,26,8,53,15.1,2020-2021
Kauppila Oskari,Jymy,25,9,6,15,10,29,47,-18,81,11.1,2020-2021
Veteläinen Asla,OLS,24,10,5,15,8,48,49,-1,87,11.5,2020-2021
Lillas Didrik,Jymy,24,10,5,15,2,21,41,-20,118,8.5,2020-2021
Perälä Niko-Arttu,Jymy,18,10,5,15,0,27,50,-23,63,15.9,2020-2021
Harjula Tuomas,Indians,23,6,8,14,0,61,40,21,32,18.8,2020-2021
Hautaoja Markus,Steelers,25,7,7,14,2,29,48,-19,54,13.0,2020-2021
Juuti Jasper,Oilers,23,8,6,14,2,24,16,8,58,13.8,2020-2021
Tykkyläinen Konsta,Classic,21,10,4,14,6,35,26,9,58,17.2,2020-2021
Pesu Eino,Oilers,24,11,3,14,4,26,15,11,46,23.9,2020-2021
Arkkila Olli,Indians,25,2,11,13,36,45,43,2,65,3.1,2020-2021
Laitinen Patrik,LASB,26,4,9,13,2,44,53,-9,40,10.0,2020-2021
Suhanto Eppu,Happee,26,6,7,13,10,52,50,2,73,8.2,2020-2021
Arola Jesse,LASB,26,6,7,13,2,27,34,-7,61,9.8,2020-2021
Sillanpää Oliver,ErVi,26,7,6,13,2,28,36,-8,63,11.1,2020-2021
Ijäs Eetu,OLS,22,7,6,13,12,32,41,-9,59,11.9,2020-2021
Myllymäki Henri,SPV,13,7,6,13,4,29,19,10,40,17.5,2020-2021
Mäenpää Matias,Jymy,20,10,3,13,4,23,32,-9,77,13.0,2020-2021
Mustonen Tuomas,SPV,26,3,9,12,6,59,44,15,41,7.3,2020-2021
Lehkosuo Otto,Indians,16,3,9,12,10,37,38,-1,53,5.7,2020-2021
Salo Tuukka,Classic,26,4,8,12,6,55,24,31,41,9.8,2020-2021
Kinnunen Olli,TPS,26,5,7,12,4,25,22,3,48,10.4,2020-2021
Laaksonen Nikolas,TPS,22,6,6,12,0,33,18,15,43,14.0,2020-2021
Suomela Antti,Oilers,25,7,5,12,2,87,43,44,47,14.9,2020-2021
Kauppinen Pyry,Steelers,20,7,5,12,2,24,33,-9,80,8.8,2020-2021
Holappa Niko-Petteri,OLS,18,7,5,12,0,28,45,-17,38,18.4,2020-2021
Hakola Jesper,Welhot,20,9,3,12,2,18,39,-21,56,16.1,2020-2021
Holopainen Riku,Oilers,17,9,3,12,0,28,18,10,80,11.3,2020-2021
Minkkinen Matti,Happee,15,9,3,12,0,23,7,16,40,22.5,2020-2021
Palin Tomi,Tiikerit,26,10,2,12,2,34,47,-13,88,11.4,2020-2021
Toropainen Santeri,Indians,19,2,9,11,2,32,42,-10,53,3.8,2020-2021
Saarela Miko,Jymy,25,4,7,11,8,42,66,-24,55,7.3,2020-2021
Kivilehto Juha,Classic,26,5,6,11,30,54,51,3,31,16.1,2020-2021
Roth Anton,KrP,25,6,5,11,6,22,24,-2,44,13.6,2020-2021
Krumins Morics,KrP,24,6,5,11,10,75,44,31,55,10.9,2020-2021
Talvitie Ilari,Oilers,25,7,4,11,12,53,27,26,92,7.6,2020-2021
Yrjänen Roope,Steelers,24,7,4,11,4,23,64,-41,54,13.0,2020-2021
Vikstedt Antti,OLS,23,7,4,11,0,17,32,-15,50,14.0,2020-2021
Kapanen Lauri,ErVi,15,7,4,11,2,46,31,15,57,12.3,2020-2021
Jalonen Ossi,ErVi,23,8,3,11,4,39,43,-4,51,15.7,2020-2021
Puntanen Eetu,Jymy,19,8,3,11,2,25,37,-12,93,8.6,2020-2021
Niemelä Petri,OLS,26,9,2,11,6,23,59,-36,60,15.0,2020-2021
Heikkilä Jeri,SPV,26,9,2,11,6,48,38,10,76,11.8,2020-2021
Alin Juuso,TPS,26,3,7,10,8,45,29,16,24,12.5,2020-2021
Storgårds Erik,TPS,25,3,7,10,8,61,27,34,46,6.5,2020-2021
Virrankari Olli-Matti,OLS,26,4,6,10,0,46,48,-2,22,18.2,2020-2021
Pentikäinen Miikka,LASB,26,4,6,10,10,44,51,-7,54,7.4,2020-2021
Lankinen Iiro,Happee,25,4,6,10,4,57,41,16,59,6.8,2020-2021
Kouvonen Jalo,KrP,21,4,6,10,6,28,24,4,21,19.0,2020-2021
Salokangas Tiitus,LASB,24,5,5,10,2,20,24,-4,61,8.2,2020-2021
Wikstedt Olli,OLS,22,5,5,10,12,36,51,-15,62,8.1,2020-2021
Pulkkinen Jere,Classic,20,5,5,10,18,76,38,38,54,9.3,2020-2021
Hyytiäinen Jani,TPS,26,6,4,10,2,17,9,8,41,14.6,2020-2021
Nylund Kevin,Indians,19,6,4,10,0,30,24,6,56,10.7,2020-2021
Harle Teemu,Welhot,26,7,3,10,4,24,63,-39,94,7.4,2020-2021
Takala Jose,Steelers,21,7,3,10,2,26,35,-9,54,13.0,2020-2021
Viitakoski Valtteri,KrP,13,7,3,10,0,19,12,7,38,18.4,2020-2021
Niinikoski Juho,ErVi,25,7,2,9,2,16,20,-4,48,14.6,2020-2021
Laine Lauri,ErVi,22,7,2,9,2,20,19,1,36,19.4,2020-2021
Välitalo Anssi,OLS,17,7,2,9,4,15,30,-15,21,33.3,2020-2021
Alkki Lauri,KrP,26,1,7,8,16,39,34,5,10,10.0,2020-2021
Taskinen Olli,Welhot,26,2,6,8,8,25,59,-34,24,8.3,2020-2021
Koskinen Ossi,Indians,26,2,6,8,8,34,32,2,36,5.6,2020-2021
Aaltonen Julius,Steelers,24,3,5,8,10,32,48,-16,48,6.3,2020-2021
Laine Ville-Martti,TPS,26,4,4,8,4,23,11,12,25,16.0,2020-2021
Venäläinen Viljami,Welhot,24,4,4,8,2,17,59,-42,53,7.5,2020-2021
Sivula Erno,Welhot,20,4,4,8,6,19,50,-31,37,10.8,2020-2021
Ragovskis Janis,LASB,26,5,3,8,6,26,36,-10,36,13.9,2020-2021
Puolakka Joni,LASB,21,5,3,8,6,30,38,-8,33,15.2,2020-2021
Henttonen Joni,KrP,23,6,2,8,0,73,41,32,22,27.3,2020-2021
Laitila Alpo,Classic,20,6,2,8,2,20,9,11,27,22.2,2020-2021
Koskinen Albert,Classic,9,6,2,8,0,12,9,3,34,17.6,2020-2021
Lamminmäki Martti,Jymy,8,6,2,8,6,12,16,-4,38,15.8,2020-2021
Akola Eemeli,Classic,26,1,6,7,2,44,23,21,38,2.6,2020-2021
Loippo Leevi,Tiikerit,23,1,6,7,0,20,21,-1,36,2.8,2020-2021
Salonen Janne,Tiikerit,26,2,5,7,26,45,65,-20,60,3.3,2020-2021
Ojala Miska,Welhot,25,2,5,7,0,20,58,-38,48,4.2,2020-2021
Holopainen Jyrki,SPV,5,2,5,7,6,16,13,3,14,14.3,2020-2021
Lokasaari Aapo,SPV,26,3,4,7,6,35,37,-2,33,9.1,2020-2021
Estovirta Tomas,KrP,25,3,4,7,4,29,14,15,30,10.0,2020-2021
Puska Perttu,Indians,24,3,4,7,6,20,23,-3,42,7.1,2020-2021
Ojala Tuomas,TPS,21,3,4,7,2,15,8,7,18,16.7,2020-2021
Auroila Jukkapekka,LASB,21,3,4,7,2,12,11,1,21,14.3,2020-2021
Koistinen Jere,Welhot,26,4,3,7,10,19,68,-49,105,3.8,2020-2021
Kanervisto Tatu,TPS,24,4,3,7,8,26,24,2,43,9.3,2020-2021
Honkaniemi Miikka,Jymy,23,4,3,7,2,21,51,-30,40,10.0,2020-2021
Majalahti Mika,ErVi,15,4,3,7,8,13,13,0,31,12.9,2020-2021
Härkönen Erik,Jymy,8,4,3,7,2,12,22,-10,45,8.9,2020-2021
Repo Juho,SPV,24,6,1,7,4,27,34,-7,39,15.4,2020-2021
Juvonen Eetu,Welhot,16,6,1,7,0,19,42,-23,53,11.3,2020-2021
Lintula Matias,SPV,26,0,6,6,4,37,45,-8,24,0.0,2020-2021
Ainoa Luka,ErVi,25,1,5,6,2,27,55,-28,22,4.5,2020-2021
Budde Karri,Tiikerit,25,2,4,6,2,30,41,-11,47,4.3,2020-2021
Salminen Tino,TPS,26,3,3,6,6,19,18,1,24,12.5,2020-2021
Nurminen Janne,TPS,26,3,3,6,2,45,33,12,32,9.4,2020-2021
Kokljuschkin Mattias,Tiikerit,26,3,3,6,2,8,21,-13,22,13.6,2020-2021
Nyman Alexander,Oilers,25,3,3,6,0,44,38,6,20,15.0,2020-2021
Huppunen Jesse-Samuli,Indians,25,3,3,6,0,25,41,-16,43,7.0,2020-2021
Tarkkanen Robert,Tiikerit,26,4,2,6,4,38,55,-17,36,11.1,2020-2021
Räsänen Juho,ErVi,24,4,2,6,10,22,31,-9,25,16.0,2020-2021
Harjula Eero,Indians,22,4,2,6,28,20,13,7,26,15.4,2020-2021
Karjanlahti Eemeli,SPV,14,5,1,6,6,10,6,4,15,33.3,2020-2021
Tenho Oskari,KrP,11,5,1,6,0,14,7,7,26,19.2,2020-2021
Juuranto Matias,Oilers,16,0,5,5,0,27,16,11,26,0.0,2020-2021
Järvikangas Viljami,Jymy,26,1,4,5,2,34,68,-34,36,2.8,2020-2021
Ranki Ville,Steelers,24,2,3,5,4,17,49,-32,18,11.1,2020-2021
Palvaila Lauri,LASB,20,2,3,5,2,32,34,-2,33,6.1,2020-2021
Liikka Saku,Happee,18,2,3,5,4,11,10,1,22,9.1,2020-2021
Ijäs Janne,Steelers,18,2,3,5,10,23,32,-9,28,7.1,2020-2021
Kallio Emil,Tiikerit,13,2,3,5,0,11,11,0,21,9.5,2020-2021
Grönfors Samuli,Happee,26,3,2,5,2,11,19,-8,38,7.9,2020-2021
Lehto Kosti,OLS,22,3,2,5,4,30,24,6,18,16.7,2020-2021
Hirsikorpi Mika,OLS,20,3,2,5,2,13,25,-12,51,5.9,2020-2021
Hakanen Riku,SPV,12,3,2,5,2,16,13,3,34,8.8,2020-2021
Laakso Kalle,Tiikerit,19,4,1,5,4,11,16,-5,19,21.1,2020-2021
Hiltunen Aleksi,Steelers,16,0,4,4,2,8,21,-13,14,0.0,2020-2021
Rynnäs Ville-Pekka,Jymy,26,1,3,4,4,29,58,-29,23,4.3,2020-2021
Hämäläinen Petteri,Jymy,24,1,3,4,10,21,47,-26,30,3.3,2020-2021
Pollari Miika,Jymy,20,1,3,4,4,18,30,-12,14,7.1,2020-2021
Tiira Lauri,OLS,19,1,3,4,8,15,41,-26,23,4.3,2020-2021
Jokela Olli,Oilers,19,1,3,4,4,14,7,7,9,11.1,2020-2021
Määttä Salomo,Jymy,18,1,3,4,4,19,37,-18,19,5.3,2020-2021
Rautio Petro,Jymy,17,1,3,4,2,12,21,-9,11,9.1,2020-2021
Viitanen Joonas,Steelers,16,1,3,4,10,26,31,-5,16,6.3,2020-2021
Viitala Lauri,Happee,25,2,2,4,4,26,25,1,37,5.4,2020-2021
Lintu Ari,Welhot,25,2,2,4,28,15,57,-42,49,4.1,2020-2021
Turpeinen Mikko,Steelers,24,2,2,4,4,22,51,-29,26,7.7,2020-2021
Keränen Kalle,Welhot,24,2,2,4,10,8,32,-24,46,4.3,2020-2021
Santanen Mikko,KrP,19,2,2,4,0,21,17,4,9,22.2,2020-2021
Silvonen Jesper,Oilers,16,2,2,4,0,10,1,9,14,14.3,2020-2021
Alatalo Pieti,Steelers,14,2,2,4,8,21,30,-9,15,13.3,2020-2021
Kilpi Otto,Classic,11,2,2,4,0,7,1,6,17,11.8,2020-2021
Lassila Jussi,Jymy,10,2,2,4,0,9,20,-11,67,3.0,2020-2021
Väänänen Roni,Welhot,16,3,1,4,6,17,37,-20,24,12.5,2020-2021
Hytönen Tuukka,Steelers,21,4,0,4,0,8,23,-15,27,14.8,2020-2021
Junnila Samuli,Indians,11,4,0,4,0,10,13,-3,18,22.2,2020-2021
Jaakonsaari Jukka,Steelers,10,4,0,4,0,11,19,-8,8,50.0,2020-2021
Lomakin Joni,Tiikerit,26,0,3,3,6,17,35,-18,9,0.0,2020-2021
Kukko Arttu,Jymy,26,1,2,3,4,40,87,-47,36,2.8,2020-2021
Ahola Timi,Steelers,26,1,2,3,10,24,52,-28,40,2.5,2020-2021
Takala Tomi,Jymy,14,1,2,3,0,8,10,-2,10,10.0,2020-2021
Vaajala Matias,Classic,22,2,1,3,4,14,10,4,26,7.7,2020-2021
Stenberg Henri,LASB,19,2,1,3,0,12,17,-5,20,10.0,2020-2021
Saarnio Mikko,OLS,18,2,1,3,4,16,35,-19,14,14.3,2020-2021
Kantanen Teemu,Tiikerit,15,2,1,3,6,13,16,-3,13,15.4,2020-2021
Saari Arttu,Jymy,11,2,1,3,0,7,17,-10,20,10.0,2020-2021
Ruonakangas Riku,OLS,8,2,1,3,0,6,4,2,9,22.2,2020-2021
Kauhanen Jesper,Welhot,7,2,1,3,0,7,23,-16,31,6.5,2020-2021
Rissanen Mika,Welhot,24,3,0,3,0,9,41,-32,48,6.3,2020-2021
Eklund Emil,KrP,21,3,0,3,14,13,10,3,26,11.5,2020-2021
Tuomala Miro,KrP,26,0,2,2,0,6,2,4,0,-,2020-2021
Pohjonen Santtu,LASB,25,0,2,2,0,0,0,0,1,0.0,2020-2021
Kvist Niko,OLS,25,0,2,2,4,22,54,-32,4,0.0,2020-2021
Jääskeläinen Pietari,Steelers,24,0,2,2,0,0,0,0,1,0.0,2020-2021
Auvinen Jasper,Indians,21,1,1,2,0,5,10,-5,20,5.0,2020-2021
Pekari Elias,Oilers,19,1,1,2,0,6,3,3,12,8.3,2020-2021
Summanen Miko,Oilers,14,1,1,2,4,9,5,4,14,7.1,2020-2021
Rantaniemi Aapo,OLS,12,1,1,2,4,12,14,-2,15,6.7,2020-2021
Luoto Elmo,KrP,12,1,1,2,0,7,7,0,2,50.0,2020-2021
Sipilä Mikko,ErVi,10,1,1,2,2,8,15,-7,8,12.5,2020-2021
Heiskanen Mika,OLS,6,1,1,2,0,4,2,2,10,10.0,2020-2021
Saarinen Sami,Steelers,4,1,1,2,2,6,10,-4,11,9.1,2020-2021
Keskinen Joel,Tiikerit,9,2,0,2,0,4,11,-7,10,20.0,2020-2021
Lehto Julius,LASB,7,2,0,2,0,6,3,3,7,28.6,2020-2021
Jaanus Janne,Tiikerit,4,2,0,2,0,3,6,-3,11,18.2,2020-2021
Kuisma Niklas,Tiikerit,26,0,1,1,2,16,30,-14,23,0.0,2020-2021
Kivilompolo Vinski,OLS,26,0,1,1,2,5,5,0,0,-,2020-2021
Kanerva Jesse,KrP,26,0,1,1,0,0,0,0,2,0.0,2020-2021
Kaltiainen Joonas,Oilers,26,0,1,1,0,6,5,1,1,0.0,2020-2021
Laakso Markus,Happee,25,0,1,1,0,9,2,7,0,-,2020-2021
Kyllönen Olli,Welhot,25,0,1,1,0,4,36,-32,18,0.0,2020-2021
Kosonen Eero,Steelers,25,0,1,1,0,0,0,0,1,0.0,2020-2021
Kainulainen Santeri,ErVi,25,0,1,1,0,15,21,-6,0,-,2020-2021
Hassinen Miko,Happee,25,0,1,1,0,0,0,0,0,-,2020-2021
Fälden Oskari,TPS,25,0,1,1,0,0,1,-1,0,-,2020-2021
Aarela Ilmari,Happee,25,0,1,1,6,14,24,-10,41,0.0,2020-2021
Toriseva Lassi,Classic,24,0,1,1,0,0,0,0,1,0.0,2020-2021
Uurtio Niko,Welhot,22,0,1,1,4,8,46,-38,29,0.0,2020-2021
Taimisto Tommi,Happee,22,0,1,1,2,2,12,-10,20,0.0,2020-2021
Soininen Mirko,Welhot,21,0,1,1,0,6,21,-15,14,0.0,2020-2021
Latvala Miika,SPV,19,0,1,1,0,10,14,-4,8,0.0,2020-2021
Kupela Konsta,ErVi,16,0,1,1,0,9,15,-6,11,0.0,2020-2021
Salonen Vesa,Jymy,13,0,1,1,2,3,13,-10,3,0.0,2020-2021
Kärkkäinen Samu,Welhot,13,0,1,1,0,3,15,-12,19,0.0,2020-2021
woivalin juuso,Classic,10,0,1,1,2,7,6,1,4,0.0,2020-2021
Haarala Tino,Jymy,10,0,1,1,2,9,13,-4,1,0.0,2020-2021
Rissanen Aarne,ErVi,9,0,1,1,0,2,2,0,9,0.0,2020-2021
Keskitalo Kalle,OLS,8,0,1,1,2,3,9,-6,11,0.0,2020-2021
Syvänen Juho,Classic,22,1,0,1,0,6,4,2,7,14.3,2020-2021
Lippojoki Aatu,ErVi,21,1,0,1,0,13,14,-1,6,16.7,2020-2021
Lehtonen Konsta,LASB,21,1,0,1,0,10,18,-8,26,3.8,2020-2021
Kotka Timi,LASB,12,1,0,1,0,2,6,-4,13,7.7,2020-2021
Kareinen Miikka,Indians,11,1,0,1,4,10,7,3,15,6.7,2020-2021
Turula Veli-Pekka,ErVi,9,1,0,1,2,9,12,-3,7,14.3,2020-2021
Kurkikangas Atte,Steelers,9,1,0,1,0,5,11,-6,8,12.5,2020-2021
Järvinen Perttu,ErVi,5,1,0,1,0,5,6,-1,6,16.7,2020-2021
Tenhonen Daniel,ErVi,2,1,0,1,0,1,2,-1,2,50.0,2020-2021
Sipilä Nemo,Tiikerit,26,0,0,0,0,0,0,0,0,-,2020-2021
Sillanpää Oskar,Classic,26,0,0,0,12,0,0,0,0,-,2020-2021
Rantaniemi Iiro,OLS,26,0,0,0,0,0,0,0,0,-,2020-2021
Nordström Niko,Oilers,26,0,0,0,0,1,0,1,0,-,2020-2021
Kuisma Olli,TPS,26,0,0,0,0,0,0,0,0,-,2020-2021
Kirvesniemi Mikko,Indians,26,0,0,0,0,0,0,0,0,-,2020-2021
Beijar Jens,Tiikerit,26,0,0,0,0,0,0,0,0,-,2020-2021
Kronqvist Anton,SPV,25,0,0,0,0,0,0,0,0,-,2020-2021
Strandberg Santtu,ErVi,24,0,0,0,0,19,20,-1,1,0.0,2020-2021
Orste Ralfs,LASB,24,0,0,0,0,3,13,-10,3,0.0,2020-2021
Lallukka Ossi,Jymy,24,0,0,0,0,3,6,-3,1,0.0,2020-2021
Kunnap Lauri,Welhot,24,0,0,0,0,0,0,0,0,-,2020-2021
Virtanen Ville-Pekka,Happee,22,0,0,0,0,7,16,-9,8,0.0,2020-2021
Vesanen Juuso,LASB,22,0,0,0,4,5,14,-9,10,0.0,2020-2021
Mutka Roope,Jymy,21,0,0,0,0,0,0,0,0,-,2020-2021
Tuononen Roni,Welhot,19,0,0,0,2,3,2,1,5,0.0,2020-2021
Ripatti Antti,LASB,19,0,0,0,0,0,0,0,0,-,2020-2021
Hopsu Severi,Indians,19,0,0,0,0,0,0,0,0,-,2020-2021
Grönholm Roope,Steelers,19,0,0,0,2,5,15,-10,4,0.0,2020-2021
Aallonen Henri,Steelers,17,0,0,0,0,4,9,-5,11,0.0,2020-2021
Mäkelä Arttu,Tiikerit,15,0,0,0,4,6,15,-9,2,0.0,2020-2021
Koponen Tony,SPV,15,0,0,0,0,1,5,-4,1,0.0,2020-2021
Jäppinen Amos,Indians,15,0,0,0,0,5,7,-2,7,0.0,2020-2021
Hasu Rasmus,SPV,13,0,0,0,0,6,10,-4,0,-,2020-2021
Tammiranta Aaro,SPV,12,0,0,0,0,0,0,0,0,-,2020-2021
Manninen Eetu,Indians,12,0,0,0,0,2,6,-4,3,0.0,2020-2021
Lindstedt Tino,KrP,12,0,0,0,4,11,4,7,2,0.0,2020-2021
Junkkari Jonatan,Indians,12,0,0,0,2,3,3,0,0,-,2020-2021
Markelin Rasmus,Oilers,11,0,0,0,24,11,3,8,7,0.0,2020-2021
Peltola Aleksi,KrP,10,0,0,0,2,0,0,0,1,0.0,2020-2021
Honko Valtteri,SPV,10,0,0,0,0,0,0,0,0,-,2020-2021
Eskelinen Niko,Welhot,10,0,0,0,0,2,16,-14,6,0.0,2020-2021
Kärkkäinen Jussi,Welhot,9,0,0,0,0,0,0,0,0,-,2020-2021
Sipilä Osku,Steelers,8,0,0,0,4,5,11,-6,7,0.0,2020-2021
Silfsten Henri,LASB,8,0,0,0,0,4,2,2,2,0.0,2020-2021
Kerola Jacob,ErVi,8,0,0,0,2,2,2,0,3,0.0,2020-2021
Kokkola Joona,Welhot,7,0,0,0,0,1,5,-4,3,0.0,2020-2021
Jokisalo Juuso,Indians,7,0,0,0,0,0,0,0,0,-,2020-2021
Ainola Aki,LASB,7,0,0,0,0,0,0,0,0,-,2020-2021
Wikström Roope,KrP,6,0,0,0,0,2,2,0,1,0.0,2020-2021
Kunelius Jaska-Petteri,Happee,6,0,0,0,2,1,5,-4,11,0.0,2020-2021
Tynkkynen Jonatan,Jymy,5,0,0,0,2,1,6,-5,7,0.0,2020-2021
Tornberg Otso,OLS,5,0,0,0,0,1,9,-8,3,0.0,2020-2021
Siira Elias,KrP,5,0,0,0,0,2,1,1,2,0.0,2020-2021
Savolainen Sami,KrP,5,0,0,0,0,2,1,1,2,0.0,2020-2021
Pylväläinen Arttu,Happee,5,0,0,0,0,0,2,-2,0,-,2020-2021
Pokela Matias,Jymy,5,0,0,0,0,0,0,0,0,-,2020-2021
Ylikojola Mikko,Tiikerit,4,0,0,0,2,1,3,-2,1,0.0,2020-2021
Tenhonen Benjamin,ErVi,4,0,0,0,0,1,2,-1,2,0.0,2020-2021
Rauhala Jani,Oilers,4,0,0,0,0,3,2,1,9,0.0,2020-2021
Metra Ulvis,Steelers,4,0,0,0,0,0,0,0,0,-,2020-2021
Kurronen Otto,OLS,4,0,0,0,0,0,0,0,1,0.0,2020-2021
Karkulowski Emil,LASB,4,0,0,0,0,0,3,-3,0,-,2020-2021
Manninen Eetu,Jymy,3,0,0,0,0,0,1,-1,1,0.0,2020-2021
Kartano Aleksi,Steelers,3,0,0,0,0,0,0,0,0,-,2020-2021
Kangas Topias,Happee,3,0,0,0,2,0,2,-2,1,0.0,2020-2021
Vähäkangas Johannes,Oilers,2,0,0,0,0,0,0,0,0,-,2020-2021
Varjokumpu Juuso,TPS,2,0,0,0,0,0,0,0,0,-,2020-2021
Savolainen Oskari,ErVi,2,0,0,0,0,1,2,-1,1,0.0,2020-2021
Ruotsalainen Joel,Welhot,2,0,0,0,0,0,1,-1,0,-,2020-2021
Ritaranta Aapo,SPV,2,0,0,0,0,0,0,0,0,-,2020-2021
Ojala Touko,ErVi,2,0,0,0,0,0,0,0,0,-,2020-2021
Mettovaara Mikko,OLS,2,0,0,0,0,1,2,-1,0,-,2020-2021
Larte Joona,Oilers,2,0,0,0,0,1,0,1,1,0.0,2020-2021
Laine Valtteri,Happee,2,0,0,0,0,0,0,0,0,-,2020-2021
Kyllinen Miro,Steelers,2,0,0,0,0,0,0,0,0,-,2020-2021
Koskela Juuso,Jymy,2,0,0,0,0,0,1,-1,4,0.0,2020-2021
Helin Niilo,Classic,2,0,0,0,0,0,0,0,0,-,2020-2021
Hannula Hannes,Jymy,2,0,0,0,0,0,0,0,1,0.0,2020-2021
Haapala Otto,SPV,2,0,0,0,0,0,0,0,0,-,2020-2021
Auvinen Otso,Classic,2,0,0,0,0,0,0,0,0,-,2020-2021
Uusi-Laitila Santeri,SPV,1,0,0,0,0,0,0,0,0,-,2020-2021
Salokangas Julius,LASB,1,0,0,0,0,0,0,0,0,-,2020-2021
Pasanen Rasmus,Indians,1,0,0,0,0,0,2,-2,0,-,2020-2021
Ollikainen Aaro,TPS,1,0,0,0,0,0,0,0,1,0.0,2020-2021
Leino Gabriel,TPS,1,0,0,0,0,0,0,0,0,-,2020-2021
Laukkanen Jarno,Welhot,1,0,0,0,0,1,1,0,0,-,2020-2021
Laitinen Leevi,Tiikerit,1,0,0,0,0,0,0,0,0,-,2020-2021
Kuutsa Eero,TPS,1,0,0,0,0,0,0,0,0,-,2020-2021
Kuusela Aaro,Oilers,1,0,0,0,0,0,0,0,0,-,2020-2021
Korhonen Teemu,LASB,1,0,0,0,0,0,0,0,0,-,2020-2021
Korhonen Matti,LASB,1,0,0,0,0,1,2,-1,6,0.0,2020-2021
Karjanlahti Eero,SPV,1,0,0,0,0,0,0,0,0,-,2020-2021
Jääskeläinen Patrik,Steelers,1,0,0,0,0,0,0,0,0,-,2020-2021
Ilmivalta Topias,Oilers,1,0,0,0,0,0,0,0,0,-,2020-2021
Heinonen Valtteri,Oilers,1,0,0,0,0,0,0,0,0,-,2020-2021
Aymard Arno,ErVi,1,0,0,0,0,0,0,0,0,-,2020-2021
